abandon	[əˈbændən]	vt.  放弃，抛弃； 离弃，丢弃； 使屈从； 停止进行，终止	n.  放任，放纵； 完全屈从于压制；	
ability	[əˈbɪləti]	n.  能力，资格； 能耐，才能；	
aboard	[əˈbɔ:d]	prep.  在（船、飞机、车）上，上（船、飞机、车）； 上车；	adv.  在船（或飞机、车）上，上船（或飞机、车）； 靠船边； 在船上； 在火车上	
abroad	[əˈbrɔ:d]	adv.  到国外，在海外； 广为流传地；	adj.  往国外的；	n.  海外，异国；	
absence	[ˈæbsəns]	n.  缺席，缺勤； 缺乏，缺少，无； 心不在焉，不注意；	
absent	[ˈæbsənt]	adj.  缺席的，不在场的； 缺少的，缺乏的； 不在意的，茫然的；	
absolute	[ˈæbsəlu:t]	adj.  绝对的，完全的； 不受任何限制[约束]的； 无条件的； 有无上权力或权威的	n.  绝对； 绝对事物；	
absorb	[əbˈsɔ:b]	vt.  吸收（液体、气体等）； 吸引（注意）； 吞并，合并； 忍受，承担（费用）	
abstract	[ˈæbstrækt]	adj.  抽象的，理论上的； 难解的； 抽象派的； 茫然的	n.  抽象概念； 抽象派艺术作品； 摘要； [化]萃取物	vt.  提取，分离； 转移（注意等）； 概括，摘录； 剽窃	
abundant	[əˈbʌndənt]	adj.  大量的，充足的； 丰富的，富有的； 丰足； 阜	
abuse	[əˈbju:s]	n.  滥用； 恶习； 侮辱； 恶言	vt.  滥用； 虐待； 辱骂；	
academic	[ˌækəˈdemɪk]	adj.  学院的，大学的，学会的，（学术，文艺）协会的； 学究的，学理上的，空谈的，非实用的； 〈美〉文科的，文学的； 柏拉图学派的	n.  学者； 大学教师，大学生，学会会员； 纸上空论，空论； [A-]柏拉图哲学信奉者	
academy	[əˈkædəmi]	n.  专科学校； 学会，学院； 一般的高等教育； 私立学校，学术团体	
accelerate	[əkˈseləreɪt]	vt.  （使）加快，（使）增速； 加速，催促； 促进； 速度增加	vi.  加快，加速；	
accent	[ˈæksent]	n.  重音； 口音； 腔调； 重音符号（标在字母上）	
acceptance	[əkˈseptəns]	n.  接受，接纳； [金融]承兑； 无怨接受（逆境、困境等）； 赞成	
access	[ˈækses]	n.  入径； 通道； 机会，权利；	vt.  到达，进入； 访问，存取（计算机信息）；	
accident	[ˈæksɪdənt]	n.  意外事件； 事故； 机遇，偶然； 附属品	
accidental	[ˌæksɪˈdentl]	adj.  意外的，偶然（发生）的； 附属的；	n.  偶然； 次要方面；	
accommodation	[əˌkɒməˈdeɪʃn]	n.  住处； 住宿； 座位，铺位； 和解	
accompany	[əˈkʌmpəni]	vt.  陪伴，陪同； 附加，补充； 与…共存； 为…伴奏	vi.  伴奏；	
accomplish	[əˈkʌmplɪʃ]	vt.  完成； 达到（目的）； 走完（路程、距离等）； 使完美	
accord	[əˈkɔ:d]	n.  协议； 条约； （色彩的）协调； 和解协议	vt.  给予； 使和谐一致； 使符合； 使适合	vi.  符合； 一致；	
accordance	[əˈkɔ:dns]	n.  一致； 和谐； 按照； 依据	
according	[ə'kɔ:dɪŋ]	adv.  依照；	v.  给予( accord的现在分词 )； 使和谐一致； 使符合； 使适合	
accordingly	[əˈkɔ:dɪŋli]	adv.  因此，于是； 依据； 照着，相应地；	
account	[əˈkaʊnt]	n.  账，账目； 存款； 描述； 解释	v.  认为是； 视为；	
accountant	[əˈkaʊntənt]	n.  会计人员，会计师；	
accumulate	None	None	
accuracy	None	None	
accurate	[ˈækjərət]	adj.  精确的，准确的； 正确无误的；	
accuse	[əˈkju:z]	v.  指责，谴责； 指控；	
accustomed	[əˈkʌstəmd]	adj.  习惯的； 通常的； 独有的； 适应的	v.  使习惯于(accustom的过去式和过去分词)；	
ache	[eɪk]	n.  疼痛；	vi.  疼痛； 渴望；	
achievement	[əˈtʃi:vmənt]	n.  完成，达到； 成就，成绩；	
acid	[ˈæsɪd]	adj.  酸味的； 尖刻的； 酸的； 酸性的	n.  酸； 酸味物质；	
acknowledge	[əkˈnɒlɪdʒ]	vt.  承认； 鸣谢； 对…打招呼； 告知已收到	
acquaintance	[əˈkweɪntəns]	n.  相识的人，熟人； 相识； 对…有了解； 知识，心得	
acquire	[əˈkwaɪə(r)]	vt.  获得，取得； 学到；	
acquisition	[ˌækwɪˈzɪʃn]	n.  获得； 购置物； 获得物； 收购	
acre	[ˈeɪkə(r)]	n.  英亩； 土地，耕地； [口]大量；	
action	[ˈækʃn]	n.  行动，活动； 功能，作用； 手段； [法]诉讼	
active	[ˈæktɪv]	adj.  积极的，活跃的，有生气的； 迅速的，敏捷的； 有效的，起作用的；	n.  [语法]主动语态； 积极分子，活跃的人；	
activity	[ækˈtɪvəti]	n.  活动； 活跃，敏捷； 活动力； 教育活动	
acute	[əˈkju:t]	adj.  尖的，锐的； 敏锐的，敏感的； 严重的，剧烈的； [医]急性的	
adapt	[əˈdæpt]	vi.  适应于，适应不同情况（或环境）(to)；	vt.  改编，改写； 改变…以适合(for)；	
addition	[əˈdɪʃn]	n.  加，增加，附加； [数]加法； 增加的人或事物；	
additional	[əˈdɪʃənl]	adj.  额外的，附加的； 另外的，追加的； 补充； 外加	
adequate	[ˈædɪkwət]	adj.  足够的； 适当的，恰当的； 差强人意的； 胜任的	
adjust	[əˈdʒʌst]	vt.& vi.  （改变…以）适应，调整，校正； 调准（望远镜等），对准，校正，校准（机械等）； 核算（盈亏）； [保]评定（赔偿要求）	
administration	[ədˌmɪnɪˈstreɪʃn]	n.  管理； 实行； （政府）行政机关； （法律、处罚等的）施行	
admire	[ədˈmaɪə(r)]	vt.  赞赏； 称赞； 欣赏； 想要	
admission	[ədˈmɪʃn]	n.  准许进入； 承认； 坦白； 入场费	
admit	[ədˈmɪt]	vt.& vi.  许可进入； 承认，供认；	vt.  允许； 确认；	vi.  承认； 允许；	
adopt	None	None	
adult	[ˈædʌlt]	adj.  成熟的； （智力、思想、行为）成熟的； 成年人的； 成年的	n.  成年的人或动物；	
advanced	[ədˈvɑ:nst]	adj.  先进的； 高等的，高深的； 年老的； 晚期的	v.  前进(advance的过去式和过去分词)； 增加； 上涨；	
advantage	[ədˈvɑ:ntɪdʒ]	n.  有利条件； 益处； 优越（性）； 处于支配地位	vt.  有利于； 有益于； 促进； 使处于有利地位	vi.  得益，获利；	
adventure	[ədˈventʃə(r)]	n.  冒险活动； 冒险经历； 奇遇；	
advertise	[ˈædvətaɪz]	vt.  做广告，做宣传； 通告，通知； 宣扬；	vi.  登广告，做广告； 做宣传；	
advertisement	[ədˈvɜ:tɪsmənt]	n.  广告，宣传； 公告； 出公告，做广告；	
advisable	[ədˈvaɪzəbl]	adj.  明智的； 可取的； 能劝告的； 适当的	
advocate	[ˈædvəkeɪt]	vt.  提倡； 拥护； 鼓吹； 为…辩护	n.  （辩护）律师； 提倡者； 支持者；	
aeroplane	[ˈeərəpleɪn]	n.  飞机；	
affect	[əˈfekt]	vt.  影响； 假装； 感动； （疾病）侵袭	n.  感情，情感，心情； [精神病学]（表露或觉察到的）情绪反应；	
affection	[əˈfekʃn]	n.  喜爱； 钟爱；	
afford	[əˈfɔ:d]	vt.  买得起； 担负得起； 提供； 给予	
afterward	['ɑ:ftəwəd]	adv.  以后，过后；	
agency	[ˈeɪdʒənsi]	n.  代理； 机构； 力量；	
agenda	[əˈdʒendə]	n.  议事日程； 待议诸事项一览表； 日常工作事项； 议程（ agendum的名词复数）	
agent	None	None	
aggressive	[əˈgresɪv]	adj.  侵略的，侵犯的，攻势的； （美）有进取心的，积极行动的； 有进取心的，有闯劲的； 好争斗的，借故生端的，爱打架的，要打架的	
agriculture	[ˈægrɪkʌltʃə(r)]	n.  农业； 农耕； 农业生产； 农学	
aid	[eɪd]	n.  帮助； 助手； 外援； 辅助设备	vt.  帮助； 资助； 救助； 促进	vi.  帮助；	
aircraft	[ˈeəkrɑ:ft]	n.  飞机，航空器，；	
airline	[ˈeəlaɪn]	n.  航线； 航空公司；	
airplane	[ˈeəpleɪn]	n.  飞机；	
airport	[ˈeəpɔ:t]	n.  机场； 航空站；	
alarm	[əˈlɑ:m]	n.  惊恐； 警报； 闹铃； 动员令	vt.  使惊恐； 警告； 给（门等）安装警报器；	
alcohol	[ˈælkəhɒl]	n.  乙醇，酒精； 含酒精的饮料；	
alert	[əˈlɜ:t]	adj.  警觉的，警惕的，注意的； 思维敏捷的； 活泼的；	n.  警报； 警戒状态；	vt.  向…报警；	
belief	[bɪˈli:f]	n.  信，信任； 信念，意见； 信条；	
beloved	[bɪˈlʌvd]	adj.  被热爱的； 亲爱的； 为…所爱的；	n.  心爱的人，可爱的人； 情人； 亲爱的教友；	
beneath	[bɪˈni:θ]	prep.  在…的下方； （表示等级）低于； （表示状态）在…掩饰之下； （表示环境）在…影响之下	adv.  在下面； 在底下；	
beneficial	[ˌbenɪˈfɪʃl]	adj.  有利的，有益的； [法]可享受利益的；	
benefit	[ˈbenɪfɪt]	n.  利益，好处； 救济金，津贴； 义演，义卖； 恩惠，恩泽	vt.  有益于，有助于； 使受益； 得益，受益；	
besides	[bɪˈsaɪdz]	adv.  而且； 此外； 以及； 更	prep.  （表示排斥）除…之外（还有）； 在…之外（还有），…之余兼；	
bet	None	None	
beyond	[bɪˈjɒnd]	prep.  超过； 越过； 那一边； 在…较远的一边	adv.  在远处； 在更远处；	n.  远处；	
Bible	[ˈbaɪbl]	n.  圣经； 有权威的书；	
bid	[bɪd]	n.  出价，投标； 努力争取； 叫牌；	v.  出价， 投标； 努力争取； 说（问候话）； 告诉 邀请；	
billion	[ˈbɪljən]	n.  十亿； 数以十亿计； 大量； 一万亿	adj.  （法美）十亿的； （英德）万亿的； 无数的；	
bind	[baɪnd]	vt.  约束； 装订； 捆绑； （用长布条）缠绕	vt.& vi.  （使）结合；	n.  窘境，困境； 捆绑； 植物的藤蔓；	
biology	[baɪˈɒlədʒi]	n.  生物学； 生物；	
blade	[bleɪd]	n.  刀片，剑； （壳、草等的）叶片； 桨叶； 浮华少年	
blank	[blæŋk]	adj.  空白的； 空的，无信息的，未填写的； 茫然的； 空虚的	n.  空的空间或地点； 填空处，空白表格； 坯； 无用的东西	vt.  消失； 挡住通路； [体育运动] 阻止（对手）得分； 打孔，盖印	vi.  走神； 逐渐消失；	
blanket	[ˈblæŋkɪt]	n.  毛毯，毯子； 毯状物； 厚的覆盖层；	adj.  总括的； 全体的； 无大差别的；	vt.  用毯覆盖； 覆盖，掩盖； （规则等）适用于；	
blast	[blɑ:st]	n.  爆炸； 一阵（疾风等）； （吹奏乐器、哨子、汽车喇叭等突然发出的）响声； 突如其来的强劲气流	vt.  击毁，摧毁； 尖响； 裁判高声吹哨； 枯萎：使枯萎	vi.  爆炸； 吼叫； 枯萎：枯萎； 攻击：严厉批评或猛烈攻击	
bleed	[bli:d]	vt.  使出血； 勒索，敲诈；	vi.  流血；	vt.& vi.  散开； 给（某人）放血； 放掉气体或水（以使某物运行正常）； 长期榨取（某人的钱）	n.  [印]出血版；	
blend	[blend]	vt.  混合； 把…掺在一起； （使）调和； 协调	vi.  掺杂； 结合； 相配，相称；	n.  混合； 混合色，合成语； 混合物；	
bloody	[ˈblʌdi]	adj.  血腥的，残忍的； 血一样的； 血染的； 嗜杀的，残忍的	adv.  非常，很；	v.  血污，血染； 使流血；	
bloom	[blu:m]	n.  （常指供观赏的）花； 开花期； 最盛期； 健康有精神的面貌	vi.  开花； 使植物繁盛； 发光，闪亮； 大量出现	
board	[bɔ:d]	n.  板； 董事会； 甲板； 膳食	vt.  上（船、车或飞机）； 收费供…膳宿； 使搭伙，使寄宿； 强行登（船）	vi.  （火车、轮船、飞机等）接受乘客； 搭伙，寄宿；	
boast	[bəʊst]	vt.  自夸，自吹自擂； 夸口说； 以有…而自豪； 自负有	n.  夸口，自负； 自负的事物，引以为傲的东西； 自夸的话； 扬言	
bold	[bəʊld]	adj.  明显的，醒目的； 勇敢的，无畏的； 莽撞的； 陡峭的	n.  粗体字； 黑体字；	
bolt	[bəʊlt]	n.  螺栓，螺钉； 闪电，雷电； 门闩； 弩箭	vt.  筛选； 囫囵吞下； （把门、窗等）闩上； 突然说出，脱口说出	vi.  （门窗等）闩上，拴住； 冲出，跳出； （马等的）脱缰； 囫囵吞下	adv.  突然地； 像箭似地； 直立地；	
bond	[bɒnd]	n.  纽带； 联系； 债券； 保释金	v.  使结合； 建立互信关系； 与…紧密联系； 与…黏合	
boom	[bu:m]	vi.  发出隆隆声； 快速发展； 暴涨；	vt.  以低沉而有回响的声音发出； 使繁荣； 使迅速发展；	n.  隆隆声； 繁荣； 激增；	
boost	[bu:st]	vt.  促进，提高； 增加； 吹捧； 向上推起	vi.  宣扬； [美国俚语]（尤指在商店）行窃，偷窃；	n.  提高，增加； 帮助； 吹捧； 加速[助推]器	
boot	[bu:t]	n.  长靴，皮靴； 防护罩； [多用于英国]行李箱； [俚语]解雇，激动	vt.  穿（靴）； 踢； [俚语]解雇； [计算机科学]引导	vi.  帮助或益处；	
border	[ˈbɔ:də(r)]	n.  边； 镶边； 包边； 边界	vt.& vi.  与…接界，在…的边上；	vt.  沿…的边，环绕…，给…镶边；	vi.  近似，毗邻；	
bore	[bɔ:(r)]	vt.  令人厌烦； 钻孔； 用钻、挖或掘的方式打通；	vi.  挖洞； 钻孔； 稳步前进； 挤过去	n.  使人讨厌的人[物]； 高潮； 膛径，口径； 钻子	
boring	[ˈbɔ:rɪŋ]	adj.  无聊的，无趣的； 令人厌烦的； 单调的，乏味的；	n.  钻孔； 钻屑；	v.  令人厌烦(bore的现在分词)；	
bounce	[baʊns]	vi.  跳，反弹； 急促地动； 拒付，退票；	vt.  弹跳； 使弹起； （使）上下晃动；	n.  弹跳； 弹性； 活力；	
bound	[baʊnd]	vi.  跳，弹跳； 限制； 接壤；	vt.  给…划界，限制； 使弹回，使跳跃； 束缚；	n.  界限，限制； 跃起； （球等的）反跳；	adj.  用带子绑住的； 有义务的； 装订的，有封面的； [化，物]结合的	
boundary	[ˈbaʊndri]	n.  分界线； 范围； （球场）边线；	
brake	[breɪk]	n.  制动器，闸； 刹车； 阻碍；	vt.& vi.  刹（车）；	
brand	[brænd]	n.  [商]商标，牌子； 烙印； 〈比喻〉污名，耻辱； 燃烧着的木头	vt.  污辱； 铭刻于； 加商标于； 打烙印于	
brass	[brɑ:s]	n.  黄铜； 铜管乐器； 钱； 黄铜饰品（尤指马挽具上的黄铜圆片）	v.  〈英〉付（款）； [冶]把…包铜； 〈口〉无耻地胡搞；	
brave	[breɪv]	adj.  勇敢的； 需要勇气的； 华丽的； 漂亮的	vt.  勇敢面对，不怕，不顾；	n.  勇士； 美洲印第安武士；	
breadth	[bredθ]	n.  宽度； 宽容； （知识、兴趣等的）广泛；	
breast	[brest]	n.  乳房，乳腺； 胸脯，胸部； 心窝，胸怀；	vt.  升高，攀登； 坚毅地面对，与…搏斗； 挺胸迎…而上；	
breed	[bri:d]	vt.  产（后代），生； 产生，导致； 优生交配； 养育，训练	vi.  产仔； 繁殖，旺盛生长；	n.  属； 种类； 类型； 血统	
breeze	[bri:z]	n.  微风； 轻而易举的事；	vi.  吹微风； 逃走；	
brick	[brɪk]	n.  砖，砖块； 砖块状物体； 一砖的厚度； 〈口〉大好人	vt.  用砖建造、砌或铺； 用砖围住或堵住；	adj.  用砖做的； 似砖的；	
bride	[braɪd]	n.  新娘，即将（或刚刚）结婚的女子； 姑娘；	
brief	[bri:f]	adj.  短暂的； （衣着）短的； 简洁的； 简明的	vt.  向…介绍基本情况； （尤指事前）向…介绍基本情况； 向…下达简令； 在…事先向…做简要指点	n.  概要； 短文； 简短声明； （争议一方的情况或论点）要点摘录	
brilliant	[ˈbrɪliənt]	adj.  明亮的； 美好的； 闪耀的； 才华横溢的	n.  宝石； 钻石；	
broom	[bru:m]	n.  扫帚； 金雀花； [无线]自动搜索干扰振荡器；	vt.  扫除； 用扫帚扫；	vi.  桩顶开花或开裂；	
brow	[braʊ]	n.  眉，眉毛； 前额； 容貌，表情； 山脊	
bubble	[ˈbʌbl]	n.  泡，水泡； 冒泡，起泡； 泡影，妄想； （欲表达的）一点感情	vt.& vi.  起泡，使冒气泡；	vi.  使冒泡，发出冒泡的声音； 洋溢着（某种感情）； 滔滔不绝地讲； 兴奋，欢闹	
bucket	[ˈbʌkɪt]	n.  水桶； 一桶（的量）； 大量； 〈俚〉交通工具	v.  用桶装，用桶运； 倾盆而下； 〈美俚〉骗； 猛开车，猛划船	
budget	[ˈbʌdʒɪt]	n.  预算； 预算案； 预算拨款； 一束	vt.& vi.  把…编入预算； 谨慎花钱；	adj.  价格低廉的； 花钱少的； 收费合理的； 便宜的	vt.  在预算中拨款给； 按预算拨（款）； 按预算来计划（或安排）； 规划	vi.  做安排(for)；	
bulb	[bʌlb]	n.  球茎，块茎植物； 电灯泡； [解剖学]肿块；	
bulk	[bʌlk]	n.  （大）体积； 大块，大量； 大多数，大部分； 主体	vt.& vi.  变得越来越大（或重要）；	vi.  显得庞大； 形成大块； 堆积起来；	vt.  使凝聚成一团或形成一堆；	adj.  大批的，大量的； 散装的；	
bullet	[ˈbʊlɪt]	n.  子弹，弹药； 弹丸； [印]着重号；	
bump	[bʌmp]	vt.& vi.  碰撞，冲撞； 颠簸；	vi.  颠簸着前进；	n.  碰撞，撞击； 肿块； 隆起物； 鹭鸶的叫声	adv.  突然地，猛烈地； 扑通一声；	
bunch	[bʌntʃ]	n.  束，串，捆； 一串，一群； 一帮，一伙； [非正式用语]大量	vt.  聚成一串，形成一串； 聚成一组； 使起褶：使（织物）起褶；	vi.  形成一串，形成一组； 打褶； 膨胀，凸出；	
bundle	[ˈbʌndl]	n.  捆； 一批（同类事物或出售的货品）； 一大笔钱； 风趣的人	vt.& vi.  收集，归拢，把…塞入；	vt.  额外免费提供（设备等），（尤指出售计算机时）赠送软件；	vi.  匆匆送走； 推搡； 赶； （成群地）匆忙赶往	
burden	[ˈbɜ:dn]	n.  负担，包袱； 责任，义务； 载货量； （诗歌，发言等的）重点	vt.  使烦恼，劳累； 向（车，船等）上装货；	
bureau	[ˈbjʊərəʊ]	n.  局； （提供某方面信息的）办事处； （美国政府部门）局； （附抽屉及活动写字台的）书桌	
burst	None	None	
butcher	[ˈbʊtʃə(r)]	n.  屠夫，屠户； 屠杀者，刽子手； 残酷的人； 肉铺	vt.  屠宰； 屠杀； 弄砸，弄糟； 把…处死刑	
butterfly	[ˈbʌtəflaɪ]	n.  蝴蝶； 蝶泳； 轻浮的人； 游手好闲的人	v.  切开摊平；	
cabbage	[ˈkæbɪdʒ]	n.  甘蓝（洋白菜、卷心菜）； 植物人，常用于英式英语； 钱，尤指纸币，常用于美式俚语； 脑袋	
cabin	[ˈkæbɪn]	n.  小木屋； 客舱； （轮船上工作或生活的）隔间；	vt.  把…关在小屋里； 使受拘束；	vi.  住在小屋里；	
cabinet	[ˈkæbɪnət]	n.  内阁； 柜橱； （有特殊用途的）小房间； 展览艺术品的小陈列室	adj.  内阁的； 秘密的； 通常陈列于柜橱内的，可保存的； 细木工制作的	
cable	None	None	
calculate	[ˈkælkjuleɪt]	vt.& vi.  计算； 估计； 打算，计划； 旨在	vt.  预测，推测；	
calculator	[ˈkælkjuleɪtə(r)]	n.  计算器； 计算者； 计算图表；	
calendar	[ˈkælɪndə(r)]	n.  日历； 历法； 日程表； （一年之中的）重大事件（或重要日期）一览表	vt.  把…记入日程表中； 把…列入表中； 为（文件等）作分类索引； 将…排入日程表	
calm	[kɑ:m]	adj.  镇定的； 平静的； （海洋，天气等）安静的，平静的； （人）从容不迫的	vt.& vi.  （使）平静，（使）镇定； （使）镇静；	n.  平静； 镇定； 安定； 无风	vt.  使安静； 使冷静； 使镇定； 使（疼痛等）减轻	vi.  安静下来，平静下来，镇静下来；	
camel	[ˈkæml]	n.  骆驼；	
campaign	[kæmˈpeɪn]	n.  运动； 竞选运动； 战役； 季节性竞赛	vi.  参加[发起]运动，参加竞选； 参战，参加战役； 作战；	
campus	[ˈkæmpəs]	n.  校园； 校区；	
canal	[kəˈnæl]	n.  运河，沟渠； 管道； 气管； 食道	vt.  建运河； 疏导；	
cancel	[ˈkænsl]	vt.  取消，注销； 抵消，偿还； 〈数〉约去；	vi.  抵消，中和；	n.  撤销，注销； 〈数〉（相）约；	
cancer	[ˈkænsə(r)]	n.  癌症，恶性肿瘤； 弊病，社会恶习； 迅速蔓延的恶劣的或危险的事物； [天]巨蟹座，巨蟹宫	
candidate	None	None	
candy	[ˈkændi]	n.  糖果； 冰糖； 〈美俚〉古柯碱，可卡因； 巧克力	vt.  （用糖煮过以）保存； 使结晶为砂糖；	adj.  〈美俚〉（服饰）花哨的； 甜言蜜语的；	
capable	[ˈkeɪpəbl]	adj.  有能力的； 熟练的； 胜任的；	
capacity	None	None	
confuse	[kənˈfju:z]	vt.  使困窘； 使混乱； 使困惑； 使更难于理解	vi.  使糊涂；	
confusion	[kənˈfju:ʒn]	n.  混乱； 混淆； 困惑；	
congratulate	[kənˈgrætʃuleɪt]	vt.  向（某人）道贺； 祝贺； （为成就或成功）感到高兴；	
congratulation	[kənˌgrætʃuˈleɪʃn]	n.  祝贺，恭喜； 贺词；	
congress	[ˈkɒŋgres]	n.  国会； 代表大会； （用于某些国家的政党名称）国民大会； 社交	vi.  开会，集合；	
conjunction	[kənˈdʒʌŋkʃn]	n.  连词； 连接； 联合，结合物； （恒星、行星等的）合	
connect	[kəˈnekt]	vt.  连接，联结； 使…有联系； 为…接通电话； 插入插座	vi.  连接； 建立关系； [体]成功击中；	
connection	None	None	
connexion	[kə'nekʃən]	n.  联系，连结；	
conquer	[ˈkɒŋkə(r)]	vt.  征服； 攻克； 打败（敌人）； 克服	vi.  得胜，胜利；	
conquest	None	None	
conscience	[ˈkɒnʃəns]	n.  良心； 道德心；	
conscious	None	None	
consent	[kənˈsent]	n.  准许，赞同； 同意； （意见等的）一致；	vi.  同意； 赞成，赞同； 允许；	
consequence	[ˈkɒnsɪkwəns]	n.  结果； 后果； 重要性；	
consequently	[ˈkɒnsɪkwəntli]	adv.  所以，因此； 因此，因而； 终于，这样； 合乎逻辑的推论是	
conservation	[ˌkɒnsəˈveɪʃn]	n.  保存； 保护； 避免浪费； 对自然环境的保护	
conservative	[kənˈsɜ:vətɪv]	n.  保守的人； （英国）保守党党员，保守党支持者；	adj.  保守的； （英国）保守党的； （式样等）不时新的；	
considerable	[kənˈsɪdərəbl]	adj.  相当大（或多）的； 该注意的，应考虑的；	
considerate	[kənˈsɪdərət]	adj.  体贴的，体谅的； 深思熟虑； 到； 慎重	
consideration	[kənˌsɪdəˈreɪʃn]	n.  考虑，考察； 照顾，关心； 报酬； 尊敬	
consist	[kənˈsɪst]	vi.  由…组成； 在于； 符合；	
consistent	[kənˈsɪstənt]	adj.  一致的； 连续的； 不矛盾的； 坚持的	
constant	None	None	
constitute	[ˈkɒnstɪtju:t]	vt.  构成，组成； 制定，设立； 等同于； 指派	
constitution	[ˌkɒnstɪˈtju:ʃn]	n.  建立，组成； 体格； 构成方式； 宪法	
construct	[kənˈstrʌkt]	vt.  修建，建造； 构成； 创立； [数]作图	n.  结构（物）； 构想； 概念；	
construction	[kənˈstrʌkʃn]	n.  建筑物； 建造； 解释； 建造物	
consult	[kənˈsʌlt]	vi.  商议，商量； [医]会诊； 咨询； 充当顾问	vt.  请教； 翻阅； 求教于； 顾及	
consultant	[kənˈsʌltənt]	n.  （受人咨询的）顾问； 会诊医生，（顾问）医生； 求教者，（与人）商议者，征求意见者，查阅者，咨询者；	
consume	None	None	
consumer	[kənˈsju:mə(r)]	n.  消费者，顾客； [生态]取食者，食物链中以其他生物为食物的生物；	
consumption	[kənˈsʌmpʃn]	n.  消费； 肺病； 耗尽； [医学]消耗性疾病	
contact	[ˈkɒntækt]	n.  接触； 触点； [医]（传染病）接触人； 门路	vt.  使接触； 与…联系； 与…通讯（或通话）；	vi.  联系，接触；	
container	[kənˈteɪnə(r)]	n.  容器； 箱，匣； 集装箱，货柜；	
contemporary	[kənˈtemprəri]	adj.  当代的，现代的； 同时代的，同属一个时期的；	n.  同代人； 同辈人； 同龄人； 当代人	
contest	[ˈkɒntest]	vt.  竞争，为…而奋争； 辩驳；	vi.  争斗； 竞争； 争夺；	
continual	[kənˈtɪnjuəl]	adj.  不间断的； 不停的； 多次重复的； 频繁的	
continuous	[kənˈtɪnjuəs]	adj.  连续的； 延伸的； 不断的； 遍布的	
contract	[ˈkɒntrækt]	n.  合同； 契约； 协议；	v.  （使）收缩，缩小,感染（疾病）；得（病）,与…订立合同（或契约）,订立…的合同（或契约）,（与…）订立（婚约）；（与…）缔结（同盟） ；	
contradiction	[ˌkɒntrəˈdɪkʃn]	n.  矛盾； 否认，反驳；	
contrary	[ˈkɒntrəri]	adj.  相反的； 违反的，反对的； 对立的； 顽固的，任性的	n.  对立或相反的事物； 对立方； [逻]反对命题；	adv.  相反地，矛盾地；	
contrast	[ˈkɒntrɑ:st]	n.  对比，对照； 差异； 对照物，对立面； [摄]反差	
contribute	[kənˈtrɪbju:t]	vt.& vi.  贡献出； 捐赠（款项）； 投稿（给杂志等）； 出力	
contribution	[ˌkɒntrɪˈbju:ʃn]	n.  贡献，捐赠，捐助； 捐赠，捐助物； 投稿，来稿； [军]（向占领地人民征收的）军税	
controversial	[ˌkɒntrəˈvɜ:ʃl]	adj.  有争议的，引起争议的，被争论的； 好争论的；	
controversy	[ˈkɒntrəvɜ:si]	n.  公开辩论； 论战；	
convenience	[kənˈvi:niəns]	n.  方便，便利； 便利设施； 个人的舒适或利益； （公共）厕所	
convention	[kənˈvenʃn]	n.  会议； 全体与会者； 国际公约； 惯例，习俗，规矩	
conventional	[kənˈvenʃənl]	adj.  传统的； 习用的，平常的； 依照惯例的； 约定的	
conversely	[ˈkɒnvɜ:sli]	adv.  相反地，颠倒地； 倒地； 反之； 反过来	
convert	[kənˈvɜ:t]	vt.  （使）转变； 使皈依； 兑换，换算； 侵占	vi.  经过转变； 被改变； [橄榄球] 触地得分后得附加分；	n.  皈依者； 改变宗教信仰者；	
convey	[kənˈveɪ]	vt.  传达，传递； 运送，输送； [法]让与，转让（财产等）； 表达	
convict	[kənˈvɪkt]	vt.  宣判有罪； 证明…有罪； 使知罪； 定…的罪	n.  罪犯；	
conviction	[kənˈvɪkʃn]	n.  定罪； 说服； 确信； 信念	
convince	[kənˈvɪns]	vt.  使相信，说服，使承认； 使明白； 使确信； 使悔悟，使认错[罪]	
cooperate	[kəʊ'ɒpəreɪt]	vi.  合作，配合，协助；	v.  合群； 互助； 结合；	
coordinate	[kəʊ'ɔ:dɪneɪt]	vt.  使协调，使调和； 整合； 使（身体各部份）动作协调； （衣服、布料等）搭配	vi.  协调； 协同； 成为同等； 被归入同一类别	
cop	None	None	
cope	[kəʊp]	vi.  成功地应付，对付； 对抗；	n.  长袍； 斗篷状覆盖物； 墙帽；	vt.  笼罩； 给…盖墙压顶；	
copper	[ˈkɒpə(r)]	n.  铜； 铜币； 紫铜色； 警察	adj.  铜制的；	vt.  镀铜；	
copyright	[ˈkɒpiraɪt]	n.  版权，著作权；	adj.  受版权保护的； 版权的；	vt.  获得…的版权；	
cord	[kɔ:d]	n.  （细）绳； 灯心绒裤；	vt.  用绳子捆绑； 堆积（柴薪）；	
core	[kɔ:(r)]	n.  中心，核心，精髓； 果心，果核； [地质学]地核； [计] 磁心	vt.  去（果）核，挖去…的果心； 提取岩芯（样品）；	
corporation	[ˌkɔ:pəˈreɪʃn]	n.  公司； 法人； 社团，团体； 〈口〉（凸出的）大肚子	
correspond	[ˌkɒrəˈspɒnd]	vi.  符合，一致； 相应； 通信；	
correspondence	[ˌkɒrəˈspɒndəns]	n.  一致，符合； 对应； 通信，信件； [艺]通感	
correspondent	[ˌkɒrəˈspɒndənt]	n.  通讯员，记者； 通信者；	
corresponding	[ˌkɒrəˈspɒndɪŋ]	adj.  相当的，对应的； 通信的； 符合的，符合。。； 一致的	v.  相符合( correspond的现在分词)； 类似(correspond的ing形式)； 相配；	
corridor	[ˈkɒrɪdɔ:(r)]	n.  走廊，通道； 走廊（一国领土通过他国境内的狭长地带）； [建]覆道；	
costly	[ˈkɒstli]	adj.  昂贵的； 代价高的；	
council	[ˈkaʊnsl]	n.  委员会； （郡、镇等）政务会； （尤指旧时讨论特定步骤的）协商会议； 市政（或地方管理）服务机构	
counsel	[ˈkaʊnsl]	n.  协商，讨论； 建议； 策略； 法律顾问，辩护人	vt.  劝告，建议； 提供专业咨询；	
counter	[ˈkaʊntə(r)]	n.  柜台； 对立面； 计数器； （某些棋盘游戏的）筹码	adj.  相反的；	vt.  反击，还击； 反向移动，对着干； 反驳，回答；	vi.  逆向移动，对着干； 反驳；	adv.  反方向地； 背道而驰地；	
county	[ˈkaʊnti]	n.  县，郡； 县民，郡民；	
court	[kɔ:t]	n.  法院，法庭； 院子，天井； 宫廷； 网球场	vt.  招致； 设法获得； 向…献殷勤； 追求	vi.  求爱，求婚； 寻求；	
courtyard	[ˈkɔ:tjɑ:d]	n.  庭院，院子； 天井；	
crack	[kræk]	vt.  破裂，打开； （使…）开裂； 说（笑话）； 开瓶	vi.  断裂，折断； 碎裂声，爆裂声； 镜子破裂了； 失去控制，衰退	n.  裂缝； 试图； 缝隙； （可听到响声的）重击	adj.  训练有素的； 技艺高超的； 优秀的； 一流的	
craft	None	None	
crane	[kreɪn]	n.  吊车，起重机； 鹤；	vt.& vi.  伸长，探头；	vi.  迟疑，踌躇；	
crash	[kræʃ]	v.  碰撞； 使发出巨响； 暴跌； 睡觉	n.  碰撞； 碰撞声； 暴跌； 崩溃	adj.  应急的； 速成的；	
dot	[dɒt]	n.  点，小圆点；	vt.  打点于； 散布于； 点缀； 以小圆点标出	
doubtful	[ˈdaʊtfl]	adj.  难以预测的； 难以预料的，未定局的； 怀疑的，拿不准的； 不明不白	
downward	[ˈdaʊnwəd]	adj.  向下的，往下的；	adv.  向下地，下行地；	
draft	[drɑ:ft]	n.  汇票； 草稿； 选派； （尤指房间、烟囱、炉子等供暖系统中的）（小股）气流	vt.  起草； 制定； 征募；	vi.  拟稿； 绘样； 作草图；	adj.  初步画出或（写出）的； （设计、草图、提纲或版本）正在起草中的，草拟的； 以草稿形式的； 草图的	
drag	[dræg]	vt.  拖拽； 吃力地往前拉； 拖地而行；	vi.  沿地面拖动； 落后； 缓慢前进； 打捞	n.  拖，拉； 累赘； 阻力；	
dragon	[ˈdrægən]	n.  龙，龙船； [D-][天文学]天龙（星座）； [口语、贬义]脾气暴躁的人；	
drain	[dreɪn]	vi.  排水； 流干；	vt.  喝光，喝干； 使（精力、金钱等）耗尽； 使流出； 排掉水	n.  排水； 下水道； 排水系统； [医]引流	
drama	[ˈdrɑ:mə]	n.  戏剧，剧本； 戏剧效果； 戏剧文学[艺术]； 戏剧性事件[场面]	
dramatic	[drəˈmætɪk]	adj.  戏剧的，戏剧性的； 引人注目的； 突然的； 巨大的	
draught	[drɑ:ft]	n.  通风； 气流； （船的）吃水深度； 一饮，一口之量	vt.  draft的变体； 起草； 征兵； 选派	adj.  汲出的； 拖拉的；	
drawer	[drɔ:(r)]	n.  抽屉； 开票人，出票人； 起草者； 酒馆侍者	
drift	[drɪft]	vi.  流动； 随意移动； 漂泊； 浮现	vt.  漂流； 堆积成山；	n.  漂移，偏移； 趋势，动向； 大意； 放任自流	
drill	[drɪl]	n.  操练； 钻头； 军事训练； （应对紧急情况的）演习	vt.& vi.  钻（孔）； 打（眼）； 操练； 训练	vt.  作…演习，操练；	
drip	[drɪp]	vt.& vi.  （使）滴下；	vi.  滴出； 含有； 充满； 充溢	n.  滴答，滴答滴答的声音； 水滴； [医]点滴； 点滴（的信息等）	
drum	[drʌm]	n.  鼓； 鼓状物； 鼓声； 石首鱼	vt.  击鼓； 连打； 反复讲； 鼓吹	vi.  击鼓； 连打； 拍翅；	
drunk	[drʌŋk]	adj.  醉的； 陶醉的； 沉醉； 飘飘然	n.  醉汉，酒鬼，酗酒者；	v.  喝（酒）( drink的过去分词)； 饮； 喝酒； （尤指）酗酒	
dull	[dʌl]	adj.  钝的； 迟钝的； 呆滞的； 阴暗的	v.  缓和； 减轻； 使阴暗；	
dumb	[dʌm]	adj.  哑的，无说话能力的； 不说话的，无声的； 沉默的，无言的； 口齿不清的，（在政府中）无代言人的，政治上无发言权的	v.  使沉默；	
dump	[dʌmp]	vt.  倾倒； 丢下，卸下； 摆脱，扔弃； 倾销	vi.  突然跌倒或落下； 卸货； 转嫁（责任等）；	n.  垃圾场； 仓库； 无秩序地累积；	
durable	[ˈdjʊərəbl]	adj.  耐用的，耐久的； 持久的； 长期的；	n.  耐用品，耐久品；	
duration	[djuˈreɪʃn]	n.  持续，持续的时间，期间； （时间的）持续，持久，连续； [语音学]音长，音延；	
dusk	[dʌsk]	n.  黄昏，傍晚； 幽暗；	adj.  微暗的； 变暗的； 〈诗〉同dusky；	v.  变暗； 使变暗；	
dye	[daɪ]	n.  染料，染色； 颜色；	vt.  染色； 给…染色；	vi.  染上或粘上（颜色）；	
dynamic	[daɪˈnæmɪk]	adj.  动态的； 动力的，动力学的； 充满活力的，精力充沛的； 不断变化的，充满变数的	n.  动态； 动力，推动变化的力量； 动力学； 活力	
eagle	[ˈi:gl]	n.  鹰； 鹰状标志； [高]比标准杆少两杆的分数；	v.  [高]低于标准杆数两杆；	
earnest	[ˈɜ:nɪst]	adj.  热心的； 诚挚的，真挚的； 重要的；	n.  热心； 认真； 定钱，保证金； 诚挚	
earthquake	[ˈɜ:θkweɪk]	n.  地震； 大变动； 动乱；	
ease	[i:z]	n.  轻松，舒适； 容易； 安逸； 不拘束，自在	vt.  解除痛苦； 减轻； 延缓； 松弛	vi.  缓解，减少； 轻松前进；	
echo	[ˈekəʊ]	n.  回声，共鸣； （言语、作风、思想等的）重复； 重复者； [无线电]回波	vt.  重复，效仿； 随声附和； 类似； 发射（声音等）	vi.  被重复； 产生回响； 充满回声；	
economic	[ˌi:kəˈnɒmɪk]	adj.  经济的； 经济学的； 合算的； 有经济效益的	
economical	[ˌi:kəˈnɒmɪkl]	adj.  节约的； 经济的； 合算的；	
economy	[ɪˈkɒnəmi]	n.  节约； 经济； 理财； 秩序	
edition	[ɪˈdɪʃn]	n.  版次，版本； （报纸、杂志的）一份； （广播、电视节目的）一期； （书、报、杂志等的）一版印刷总数	
editor	[ˈedɪtə(r)]	n.  编辑，编者； 校订者； [计]编辑软件，编辑程序；	
editorial	[ˌedɪˈtɔ:riəl]	adj.  编辑的，主笔的； 〈美〉社论的；	n.  社论（美）；	
educate	None	None	
effective	[ɪˈfektɪv]	adj.  有效的； 起作用的； 实际的，实在的； 给人深刻印象	n.  [军]现役兵额，有生力量，精兵；	
efficiency	[ɪˈfɪʃnsi]	n.  效率，效能； 实力，能力； [物]性能； 功效	
efficient	[ɪˈfɪʃnt]	adj.  有效率的； （直接）生效的； 能干的； （因省钱、省时或省力等而）收效大的	
effort	[ˈefət]	n.  努力，尝试； 工作； 成就； 杰作	
elaborate	[ɪˈlæbərət]	vi.  详尽说明； 变得复杂；	vt.  详细制定； 详尽阐述； [生理学]加工； 尽心竭力地做	
elastic	[ɪˈlæstɪk]	adj.  有弹力的； 可伸缩的； 灵活的；	n.  松紧带，橡皮圈；	
elbow	[ˈelbəʊ]	n.  肘部； 弯头，扶手； 肘形管，弯管；	vt.  用肘推挤（另一人或另一些人）； 用手肘推开；	vi.  用肘推搡着前进； 在拐角处转弯；	
elderly	[ˈeldəli]	adj.  上了年纪的； 过了中年的； 较老的；	n.  老人；	
elect	[ɪˈlekt]	vt.  选举； 挑出，挑选； 决定；	vi.  选择，挑选； 进行选举；	adj.  精选的，选出的； 选中的，当选而尚未就职的；	n.  被选的人；	
election	[ɪˈlekʃn]	n.  选举，当选； 选举权； [神]神的选择；	
electric	[ɪˈlektrɪk]	adj.  电的，带电的； 发电的，导电的； 令人激动的； 电动的	n.  电动车辆； 带电体；	
electrical	[ɪˈlektrɪkl]	adj.  用电的，与电有关的，电学的； 令人激动的，紧张的，惊人的；	
electricity	[ɪˌlekˈtrɪsəti]	n.  电力； 电流，静电； 高涨的情绪； 紧张	
electron	[ɪˈlektrɒn]	n.  电子；	
electronic	[ɪˌlekˈtrɒnɪk]	adj.  电子的； 电子操纵的； 用电子设备生产的； 用电子设备完成的	
elegant	[ˈelɪgənt]	adj.  （人或其举止）优美的； 漂亮的； 简炼的； 简洁的	
element	[ˈelɪmənt]	n.  [化]元素； 要素； 原理； [电]电阻丝	
elementary	[ˌelɪˈmentri]	adj.  基本的； 初级的； [化]元素的； 初等	
elevator	[ˈelɪveɪtə(r)]	n.  电梯； 升降舵； 谷仓；	
eliminate	[ɪˈlɪmɪneɪt]	vt.  排除，消除； 淘汰； 除掉； 干掉	
elsewhere	[ˌelsˈweə(r)]	adv.  在别处，到别处； 他；	
embarrass	[ɪmˈbærəs]	vt.& vi.  （使）窘迫，（使）局促不安； （使）困难；	
embassy	[ˈembəsi]	n.  大使馆； 大使馆全体成员； 大使的职务（地位）； 重任，差使	
embrace	[ɪmˈbreɪs]	vt.& vi.  拥抱；	vt.  包括； 包含； 接受； 信奉	n.  拥抱； 怀抱；	
emerge	[iˈmɜ:dʒ]	vi.  出现，浮现； 暴露； 摆脱；	
emergency	[iˈmɜ:dʒənsi]	n.  紧急情况； 突发事件； 非常时刻；	adj.  紧急的，应急的；	
emit	[iˈmɪt]	vt.  发出； 发射； 颁布； 发表	
emotion	[ɪˈməʊʃn]	n.  情感，感情； 情绪； 感动，激动；	
emotional	[ɪˈməʊʃənl]	adj.  表现强烈情感的； 令人动情的； 易动感情的； 感情脆弱的	
emperor	[ˈempərə(r)]	n.  皇帝，君主；	
emphasis	[ˈemfəsɪs]	n.  强调； 着重； （轮廓、图形等的）鲜明； 突出，重读	
emphasize	[ˈemfəsaɪz]	vt.  强调，着重； 加强语气； 使突出；	
empire	[ˈempaɪə(r)]	n.  帝国，帝国领土； 帝权，君权，最高统治权； 大企业组织；	adj.  新古典风格的；	
employee	[ɪmˈplɔɪi:]	n.  雇工，雇员，职工；	
employer	[ɪmˈplɔɪə(r)]	n.  雇主，老板； 雇佣者；	
employment	[ɪmˈplɔɪmənt]	n.  雇用； 使用； 职业； 有益的活动	
enable	[ɪˈneɪbl]	vt.  使能够，提供做…的权利[措施]； 使可能； 授予权利或方法；	
enclose	[ɪnˈkləʊz]	vt.  （用墙、篱笆等）把…围起来； 把…装入信封； 附入；	
encounter	[ɪnˈkaʊntə(r)]	vt.  不期而遇； 遭遇； 对抗；	n.  相遇，碰见； 遭遇战； 对决，冲突；	vi.  碰见，尤指不期而遇；	
encourage	[ɪnˈkʌrɪdʒ]	vt.  鼓励，鼓舞； 支持； 促进； 鼓动	
ending	[ˈendɪŋ]	n.  结局； 结束； 终结； 最后部份	v.  结束，终止(end的现在分词)；	
endless	[ˈendləs]	adj.  无尽的，无边的； 没完没了的； 永久的； 环形的，无端的	
endure	[ɪnˈdjʊə(r)]	vt.  忍耐； 容忍；	vi.  持续，持久； 忍耐；	
enforce	[ɪnˈfɔ:s]	vt.  强迫服从； 实施，执行； 加强；	
engage	[ɪnˈgeɪdʒ]	vt.  吸引住； 聘用、雇佣； 与…交战； 使全神贯注、引起注意	vi.  与…建立密切关系； 衔接； 参与； 紧密结合	
former	[ˈfɔ:mə(r)]	adj.  以前的，从前的； 在前的； 前任的；	n.  模型，样板； 构成者，创造者； 起形成作用的人； [无线]线圈架	
formula	[ˈfɔ:mjələ]	n.  公式，准则； 客套话； 方案； 婴儿食品	
forth	[fɔ:θ]	adv.  向前，向前方； 露着的，往外的； [废语]出外，离家；	prep.  出自，从…离开；	
fortnight	[ˈfɔ:tnaɪt]	n.  两星期，十四天；	
fortunately	[ˈfɔ:tʃənətli]	adv.  幸运地；	
foundation	[faʊnˈdeɪʃn]	n.  地基； 基础； 基金（会）； 粉底	
fountain	[ˈfaʊntən]	n.  人造喷泉，喷泉水； 泉源； 液体贮存器，汽水桶，冷饮柜； 源头，来源	
fraction	None	None	
fragment	[ˈfrægmənt]	n.  碎片； 片段，未完成的部分； （将文件内容）分段；	vt.  （使）碎裂，破裂，分裂；	vi.  破碎，碎裂；	
frame	[freɪm]	n.  框架； 构架，骨架； 眼镜框； 体系	v.  作伪证陷害； 给…做框； 制定； 表达	
framework	[ˈfreɪmwɜ:k]	n.  构架； 框架； （体系的）结构； 机构，组织	
frank	[fræŋk]	adj.  坦白的，直率的； 清楚表明的； 明显的；	n.  弗兰克； 免费邮寄权； 免费邮戳或签名； 免费邮寄的信件	vt.  免费寄（邮件）； 盖免费邮寄公章； 盖邮戳； 便于使（人）自由地来往	
freight	[freɪt]	n.  货运，货物； 运费； 船运货物； 货运列车	vt.  运输； 装货于；	
frequency	[ˈfri:kwənsi]	n.  频繁性； [数][物]频率，次数； 频率分布；	
frequent	[ˈfri:kwənt]	adj.  频繁的，时常发生的，常见的； （脉搏等）急促的，快的；	
frog	[frɒg]	n.  青蛙； 〈侮辱〉青蛙佬，对法国人的蔑称； [交]铁路辙叉； 饰扣，挂环	
frontier	[ˈfrʌntɪə(r)]	n.  边疆，边境； 边界，边缘； 尚待开发的领域；	adj.  边疆的，边界的； 新垦地的，边地的； 开拓的；	
frost	[frɒst]	vt.& vi.  使结冰霜； 冻坏； （在蛋糕上）撒糖霜；	vi.  结霜； 受冻；	n.  霜冻，结霜； 严寒，寒冷； 冷淡；	
frown	[fraʊn]	vt.& vi.  皱眉； 不同意； 蹙额；	n.  皱眉，蹙额；	
fruitful	[ˈfru:tfl]	adj.  果实累累的； 肥沃的； 效果好的；	
frustrate	[frʌˈstreɪt]	vt.  挫败； 阻挠； 使受挫折；	adj.  无益的，无效的；	
fry	[fraɪ]	n.  鱼苗，鱼秧； 弗赖伊（姓氏）； 油炸食物； （口语）烦恼，愤激	vi.  用油煎； 用油炸烤炒； 油炸；	vt.  油炸； 油煎； （美俚）使被处电刑； 瓦解	
fuel	[ˈfju:əl]	n.  燃料； （为身体提供能量的）食物； （维持、增加感情的）刺激物； 竞选提神（或兴奋）剂（一种健怡可乐，饮用后能使人精力充沛地从事竞选活动）	vt.  给…加燃料，给…加油； 激起；	vi.  补充燃料；	
fulfil	None	None	
fulfill	[fʊl'fɪl]	vt.  履行（诺言等）； 执行（命令等）； 达到（目的）； 使结束	
function	[ˈfʌŋkʃn]	n.  功能，作用； 因变量，函数； 职务； 重大聚会	vi.  有或起作用； 行使职责；	
fund	[fʌnd]	n.  基金； 储备； 现款； 特别基金管理机构	vt.  积存； 为…提供资金； 提供资金偿付（债款等）的本息； 把（短期借款）转为有固定利息的长期借款	
fundamental	[ˌfʌndəˈmentl]	adj.  基础的，基本的，根本的，重要的，原始的，主要的，十分重大的； [物]基频的，基谐波的； [乐]基音的；	n.  原理，原则，基本，根本，基础； [乐]基音； [物]基频，基谐波；	
funeral	[ˈfju:nərəl]	n.  葬礼，丧礼； 〈比喻〉不愉快的事，操心的事，有关系的事；	adj.  葬礼的； 出殡用的，出殡时的；	
fur	[fɜ:(r)]	n.  毛皮； 软毛； 毛皮衣服； 人造毛	adj.  含羊毛的；	vt.  用毛皮覆盖； 除去（锅上的）水垢；	
furnace	[ˈfɜ:nɪs]	n.  熔炉，火炉； 极热的地方； 严峻的考验或磨难；	
furnish	[ˈfɜ:nɪʃ]	vt.  陈设，布置； 提供，供应； 装修（房屋）；	
furniture	[ˈfɜ:nɪtʃə(r)]	n.  家具； 设备； 附属品；	
furthermore	[ˌfɜ:ðəˈmɔ:(r)]	adv.  此外； 而且； 与此同时； 再者	
fuss	[fʌs]	n.  忙乱； 大惊小怪； 大惊小怪的人； 争吵	vi.  忙乱； 大惊小怪； 抱怨；	vt.  使烦恼，使烦忧； 使急躁；	vt.& vi.  瞎忙一气，过分关心；	
gallery	[ˈgæləri]	n.  画廊，走廊； （教堂，议院等的）边座； 旁听席； 大批观众	
gallon	None	None	
gang	[gæŋ]	n.  帮派，团体； 盗贼等的)一帮； （工具，机械等的）一套； 〈美俚〉棒球队	vt.  使结成一帮； 成群地袭击；	vi.  结伙行动；	
gaol	[dʒeɪl,dʒel]	n.  监狱，拘留所；	vt.  监禁；	
gap	[gæp]	n.  缺口； 分歧； 间隔； 美国休闲服饰品牌	vt.  造成缝隙； 使成缺口； 使豁裂；	vi.  豁开； 张开； 有缺口； 露出裂口	
garbage	[ˈgɑ:bɪdʒ]	n.  垃圾； 脏东西； 丢弃的食物； 无用的数据	
gardener	['ɡɑ:dnə(r)]	n.  园丁，园艺家； 花匠； 菜农； 园艺爱好者	
garlic	[ˈgɑ:lɪk]	n.  大蒜； 蒜头；	
gasoline	[ˈgæsəli:n]	n.  汽油；	
gaze	[geɪz]	vi.  凝视，注视；	n.  凝视，端详；	
gear	[gɪə(r)]	n.  齿轮； 排挡； 传动装置； 衣服	vi.  接上； 调和；	vt.  使适应； 装上齿轮； 用齿轮连接；	
gene	[dʒi:n]	n.  基因； 遗传因子；	
generally	[ˈdʒenrəli]	adv.  一般地，通常； 广泛地，普遍地； 概括地； 主要地	
generate	[ˈdʒenəreɪt]	vt.  形成，造成； 产生物理反应； 产生（后代）； 引起	
generator	[ˈdʒenəreɪtə(r)]	n.  发电机，发生器； 电力公司； 生产者，创始者； [乐]基础低音	
generous	[ˈdʒenərəs]	adj.  慷慨的，大方的； 丰盛的； 肥沃的； 浓厚的	
genius	[ˈdʒi:niəs]	n.  天才； 天赋； 天才人物； （特别的）才能	
genuine	[ˈdʒenjuɪn]	adj.  真正的； 坦率的，真诚的； 血统纯粹的，纯种的； [医学]真性的	
geometry	[dʒiˈɒmətri]	n.  几何学； 几何形状； 几何图形； 几何学著作	
germ	[dʒɜ:m]	n.  [生]幼芽，胚芽； 微生物； 起源，萌芽；	
gesture	[ˈdʒestʃə(r)]	n.  手势，姿势； 举止，动作； 〔古语〕仪态； [计算机]光笔指令	vt.  做手势；	vi.  用手势表现，表达或指导；	
ghost	None	None	
giant	[ˈdʒaɪənt]	n.  巨人，大汉； 巨兽，巨物； 卓越人物；	adj.  特大的，巨大的； 伟大的；	
given	[ˈgɪvn]	adj.  指定的，确定的； 假设的，假定的； 有…倾向的； 赠送的	prep.  （表示原因）考虑到； （表示假设）倘若，假定；	n.  假设；	v.  给予，赠送( give的过去分词)；	
glance	[glɑ:ns]	vi.  一瞥； 闪微光； 掠过，擦过； 随便提到，简略地触及	n.  浏览； 闪光； 歪斜，一掠；	
glimpse	[glɪmps]	n.  一瞥，一看； （古语）闪光； 隐约的闪现； 模糊的感觉	vi.  瞥见；	
global	[ˈgləʊbl]	adj.  全球的，全球性的，有关全球大局的； 全面的，整体的，全局的； 球形的，球状的，球面的，球体的； [计]全程的	
globe	[gləʊb]	n.  球，球状物； 地球，世界； 天体； 地球仪	v.  （使）成球状；	
glorious	[ˈglɔ:riəs]	adj.  辉煌的； 荣誉的； 极好的； 非常愉快的	
glory	[ˈglɔ:ri]	n.  光荣，荣誉； 壮观，壮丽； （对上帝的）赞颂； 非常美的事物	vi.  得意，自豪； 骄傲；	
glove	[glʌv]	n.  手套； 棒球手套； 拳击手套；	vt.  给…戴手套； 用…的手套；	
glow	[gləʊ]	vi.  发光，灼热； 脸红； 洋溢，喜形于色；	n.  白热，炽热； 色彩鲜艳，尤指红光； 激情； 热烈	
glue	[glu:]	vt.  胶合； 紧附于；	n.  胶水； 胶粘物； 粘聚力；	
golf	[gɒlf]	n.  高尔夫球； 高尔夫球运动；	vi.  打高尔夫球；	
goodness	[ˈgʊdnəs]	n.  良好； 善良； 精华； 上帝	int.  天哪，哎呀；	
govern	[ˈgʌvn]	vt.  统治； 管理； 治理； 支配（词或短语的形式或用法）	vi.  控制，支配； 操纵；	
governor	[ˈgʌvənə(r)]	n.  主管人员； 统治者，管理者； 州长； [机]节速器，调节器	
grab	[græb]	vt.& vi.  抢先，抢占；	vt.  夺取或抓住； 抢夺，霸占； 匆匆拿走； 〈俚〉吸引注意力	vi.  抓住，攫取； 夺取；	n.  不法所得； 被抓住的人； 抓取装置；	
grace	[greɪs]	n.  恩泽； 优雅； 慈悲； 魅力	v.  使优美； 惠赐；	
graceful	[ˈgreɪsfl]	adj.  优美的，优雅的； 雅致的，美好的； 得体的； 飘逸	
gradual	[ˈgrædʒuəl]	adj.  渐进的，渐（升）降的； 倾斜度小的； 逐次的，逐渐的； 平缓的	n.  弥撒升阶圣歌； 弥撒圣歌集；	
graduate	[ˈgrædʒuət]	vi.  渐变； 渐渐变为（与into连用）； 渐渐消逝（与away连用）； 取得资格（与as连用）	vt.  授予学位或毕业证书； 从…接受学位； 分成等级； 标以刻度	n.  毕业生； 大学毕业生； （已经取得学士学位正在攻读高级学位的）研究生； 量筒	adj.  毕业了的，研究生的； 有（学士）学位的；	
grain	[greɪn]	n.  谷物，粮食； （沙，金，盐等的）颗粒； 谷粒，籽粒； （木材，大理石等的）纹理	vt.  把…作成细粒； 把…漆[画]成木纹； 染透； 刮去（皮上的）毛	vi.  成谷粒；	
gram	[græm]	n.  绿豆； 鹰嘴豆； 绿豆种子； 克	
grammar	[ˈgræmə(r)]	n.  语法； 语法书； （学术的）基本原理； （人的）语言知识及运用能力	
gramme	[ɡræm]	n.  克；	
inner	[ˈɪnə(r)]	adj.  内部的，内心的； 精神的； 秘密的；	n.  内部，里面； 射中接近靶心部分的一发；	
innocent	[ˈɪnəsnt]	adj.  无辜的，无罪的； 清白的； 天真无邪的； 无知的	n.  无辜者； 头脑简单的人； 天真无邪的人；	
input	[ˈɪnpʊt]	n.  输入，投入； 输入电路； 输入端； 输入的数据	vt.  把…输入电脑； [自][电子] 输入； 输入，给料；	
inquire	[ɪn'kwaɪə(r)]	vt.& vi.  打听，询问； 查究；	
inquiry	[ɪn'kwaɪərɪ]	n.  调查，审查； 询问，质问，质询，追究； 探究； 打听	
insect	[ˈɪnsekt]	n.  虫，昆虫； 卑鄙的人； 微贱的人，小人；	adj.  昆虫的； 卑劣的；	
insert	[ɪnˈsɜ:t]	vt.  插入； 嵌入； （在文章中）添加； 加插	n.  添入物（尤指一页印刷品图中插入或套印的小图）； （书报的）插页； 插入物； 添加物	
insight	[ˈɪnsaɪt]	n.  洞察力，洞悉； 直觉，眼光； 领悟； 顿悟	
insist	[ɪnˈsɪst]	vt.& vi.  坚持； 强调； 坚决要求； 坚决认为	
inspect	[ɪnˈspekt]	vt.  检查，检验； 视察；	vi.  进行检查； 进行视察；	
inspire	[ɪnˈspaɪə(r)]	vt.  鼓舞； 激励； 赋予灵感； 启迪	vi.  吸，吸入；	
install	[ɪnˈstɔ:l]	vt.  安装； 安顿，安置； 任命； 使…正式就职	
installation	[ˌɪnstəˈleɪʃn]	n.  安装； 装置； 永久性军事基地； 就职	
instance	[ˈɪnstəns]	n.  例子，实例； 情况； 要求，建议； [法]诉讼手续	vt.  举…为例；	
instant	[ˈɪnstənt]	n.  瞬间，顷刻； 此刻； 当月； 速食食品，即溶饮料	adj.  立即的； 迫切的； 正在考虑的，目前的； 即食的	
instead	[ɪnˈsted]	adv.  代替，顶替； 反而； 反倒；	
instinct	[ˈɪnstɪŋkt]	n.  本能，天性； 冲动； 天资，天才；	adj.  深深地充满着；	
institute	[ˈɪnstɪtju:t]	vt.  建立； 制定； 开始； 着手	n.  协会； 学会； 学院； （教育、专业等）机构	
institution	[ˌɪnstɪˈtju:ʃn]	n.  （大学、银行等规模大的）机构； 惯例，制度，规定，建立； 社会事业机构； 名人，名物	
instruct	[ɪnˈstrʌkt]	vt.  教，讲授； 教导，指导； 通知； 命令	
instruction	[ɪnˈstrʌkʃn]	n.  授课； 教诲； 传授的或获得的知识，课程； [计算机科学]指令	
instrument	[ˈɪnstrəmənt]	n.  仪器； 手段，工具； 乐器； 法律文件	vt.  用仪器装备； 为演奏谱曲； 向…提交文书；	
insult	[ɪnˈsʌlt]	vt.  侮辱，凌辱； 辱骂； 损害；	
insurance	[ɪnˈʃʊərəns]	n.  保险，保险业； 保险费； 预防措施；	adj.  [体]巩固球队领先局面，使对手不能因增加一分而成平局的；	
insure	[ɪnˈʃʊə(r)]	vt.  保证； 确保； 为…保险； 投保	vi.  买卖或卖保险；	
integrate	[ˈɪntɪgreɪt]	v.  合并； 成为一体； 加入； 融入群体	
intellectual	[ˌɪntəˈlektʃuəl]	adj.  智力的； 有才智的； 需用智力的； 智力发达的	n.  知识分子； 脑力劳动者； 有极高智力的人； 凭理智（而非感情）办事的人	
intelligence	[ɪnˈtelɪdʒəns]	n.  智力； 聪颖； 情报； 情报机构	
intelligent	[ɪnˈtelɪdʒənt]	adj.  聪明的； 理解力强的； 有智力的； [计]智能的	
intend	[ɪnˈtend]	vt.  意欲，计划； 为特殊目的而设计； 为特定用途而打算； 意指或意味	vi.  怀有某种意图或目的；	
intense	[ɪnˈtens]	adj.  热情的，强烈的，紧张的； 热烈的，热情的，认真的； [摄]（底片）明暗度强的； 有强烈感情（或意见、想法）的	
intensity	[ɪnˈtensəti]	n.  强烈； （感情的）强烈程度； 强度； 烈度	
intensive	[ɪnˈtensɪv]	adj.  加强的，强烈的； [农]精耕细作的； [语]加强语意的； （农业方法）集约的	n.  加强器； [语]强义词，强调成份；	
intention	[ɪnˈtenʃn]	n.  意图，目的； 意向； 意义，意旨； [医]愈合	
interaction	[ˌɪntər'ækʃn]	n.  一起活动； 合作； 互相影响； 互动	
interest	[ˈɪntrəst]	n.  兴趣，爱好； 利害关系，利益； 利息； 趣味，感兴趣的事	vt.  使产生兴趣； 使参与，使加入； 引起…的意愿； 使产生关系	
interfere	[ˌɪntəˈfɪə(r)]	vi.  干预，干涉； 调停，排解； 妨碍，打扰；	
interference	[ˌɪntəˈfɪərəns]	n.  干涉，干扰，冲突； 介入； 妨碍，打扰，阻碍物； 冲突，抵触	
interior	[ɪnˈtɪəriə(r)]	n.  内部； 内地； 内政； 内心	adj.  内部的； 内地的，国内的； 内面的；	
intermediate	[ˌɪntəˈmi:diət]	adj.  中间的，中级的；	n.  中间物，中间分子，中间人；	vi.  调解：充当调解人，调解； 干涉；	
internal	[ɪnˈtɜ:nl]	adj.  国内的； 内部的； 体内的； 内心的	prep.  （机构）内部的；	n.  内脏，内部器官； 本质，本性；	
interpret	None	None	
interpretation	[ɪnˌtɜ:prɪˈteɪʃn]	n.  解释，说明； 翻译； 表演，演绎； 理解	
interrupt	[ˌɪntəˈrʌpt]	vt.& vi.  打断（别人的话等）； 阻止； 截断；	vt.  暂停； 中断； 打扰； 妨碍	vi.  打断；	n.  中断； 暂停；	
interval	[ˈɪntəvl]	n.  间隔； 幕间休息； （数学）区间；	
interview	[ˈɪntəvju:]	n.  接见； 采访； 面试； 会谈	vt.& vi.  面试；	vt.  采访； 访问； 会见； （私下）提问	
intimate	[ˈɪntɪmət]	adj.  亲密的，亲近的； 私人的，个人的； 内部的； 直接的	n.  至交； 密友；	v.  暗示，提示； 宣布，通知；	
introduction	[ˌɪntrəˈdʌkʃn]	n.  介绍； 引言，导言； 采用，引进； 新采用的东西	
invade	[ɪnˈveɪd]	vt.& vi.  侵入，侵略； 进行侵略； 蜂拥而入，挤满； （疾病，声音等）袭来，侵袭	vt.  涌入； 侵袭； 侵犯； 干扰	
invasion	[ɪnˈveɪʒn]	n.  入侵，侵略； 侵害，侵犯； 侵袭； [医]发病	
invent	[ɪnˈvent]	vt.  发明，创造； 虚构；	
invention	None	None	
invest	[ɪnˈvest]	vt.& vi.  投资； 花费；	vt.  授予，使就职； 给…穿衣，装饰； 使充满； 覆盖	
investigate	[ɪnˈvestɪgeɪt]	vt.  调查； 审查； 研究；	vi.  作调查；	
investment	[ɪnˈvestmənt]	n.  投资，投资额； 封锁； （时间、精力的）投入； 值得买的东西	
invisible	[ɪnˈvɪzəbl]	adj.  看不见的； 不易为视线所见的，隐匿的； 无形的（指银行、旅游等服务）； 不引人注目的	n.  看不见的人；	
invitation	[ˌɪnvɪˈteɪʃn]	n.  招待，邀请； 请柬，请帖； 引诱，吸引，诱惑；	
involve	[ɪnˈvɒlv]	vt.  包含； 使参与，牵涉； 围绕，缠绕； 使专心于	
inward	[ˈɪnwəd]	adj.  向内的； 内部的； 本质上的； 亲密的	adv.  向内； 内心里；	n.  内部； 内脏；	
isolate	[ˈaɪsəleɪt]	vt.  使隔离，使孤立； [电]使绝缘； [化]使离析； [微]使细菌分离	vi.  隔离，孤立；	n.  [微]分离菌； 隔离种群；	adj.  隔离的，分离的； 孤立的；	
issue	[ˈɪʃu:]	n.  问题； 议题； （报刊的）期，号； 发行	vt.  宣布； 发给； 发表； 发行	
item	[ˈaɪtəm]	n.  条，条款； 项目； 一则； 一件商品（或物品）	
jail	[dʒeɪl]	n.  监狱； 拘留所；	vt.  监禁； 拘留；	
jar	[dʒɑ:(r)]	n.  罐子； （啤酒）杯； 缸； 猛然震动	vi.  发出刺耳的声音； 不和谐； 不一致； （对…）产生不快的影响	vt.  使震动；	
jaw	[dʒɔ:]	n.  下巴； 颌； 唠叨； 狭窄入口	vi.  闲谈； 唠唠叨叨，喋喋不休； 教训；	
jazz	[dʒæz]	n.  爵士乐，爵士舞（曲）；	
jealous	[ˈdʒeləs]	adj.  妒忌的； 羡慕的； 精心守护的； 吃醋的	
jeans	[dʒi:nz]	n.  牛仔裤； 瘦腿紧身裤；	
jet	[dʒet]	n.  喷嘴，喷雾； 喷气式飞机； 喷射流； 煤玉	vi.  乘喷气式飞机； 射出；	adj.  黑玉制的或黑玉似的； 象炭一般黑的；	vt.  喷射，喷出；	
jewel	[ˈdʒu:əl]	n.  宝石，宝石饰物； 受珍视的人[物]； 宝贝，手表的宝石轴承；	
joint	[dʒɔɪnt]	adj.  共同的，联合的； 共享的； 两院的； 连带的，共同的	n.  [解]关节； 接合处； 下流场所； 一块烤肉（英式英语）	vt.  结合，联合； 为…装上接头，使…有接缝；	
journal	[ˈdʒɜ:nl]	n.  日报，日志，日记； 定期刊物，期刊，杂志； [会计]分类账；	
journalist	[ˈdʒɜ:nəlɪst]	n.  新闻工作者，新闻记者； 记日志者；	
journey	[ˈdʒɜ:ni]	n.  旅行，旅程行期； 历程，过程；	vi.  旅行，出游；	vt.  在…旅行或旅行到过…；	
judgement	[ˈdʒʌdʒmənt]	n.  判断，鉴定，评价，判断； 审判，裁判，判决； 看法，意见； 判断力，见识	
jungle	[ˈdʒʌŋgl]	n.  （热带）丛林； 丛林音乐； 乱七八糟的一堆事物； 尔虞我诈的环境	
junior	[ˈdʒu:niə(r)]	adj.  较年幼的，较年小的； 三年级的，低年级的； 资历较浅的； 后进的	n.  年少者，青少年； 晚辈； 三年级生； 职位较低者	
jury	[ˈdʒʊəri]	n.  陪审团； （展览会，竞赛等的）全体评审员； 舆论的裁决； 评判委员会	adj.  应急的； [航]（船上）应急用的； 暂时的；	
justice	[ˈdʒʌstɪs]	n.  正义； 公正； 法律制裁； 审判员，法官	
justify	[ˈdʒʌstɪfaɪ]	vt.  证明…有理； 为…辩护； 对…作出解释；	vi.  整理版面； 证明合法；	
keen	[ki:n]	adj.  厉害的，强烈的； 敏锐的，敏捷的； 锐利的； 热心的	vi.  （为死者）恸哭，哀号；	n.  〈英〉号哭，恸哭；	
minor	[ˈmaɪnə(r)]	adj.  较小的，少数的，小…； 未成年的； [乐]小调的，小音阶的； （两同姓男孩中）年幼的	n.  未成年人； 副修科目； 小公司； [逻辑学]小前提	vi.  [主美国英语]副修，选修，兼修；	
minority	[maɪˈnɒrəti]	n.  少数； 少数民族； 未成年；	
minus	[ˈmaɪnəs]	prep.  （表示否定）没有； 缺少； （表示运算）减去； （表示数目）在零度以下	n.  减号； 负号； 不利； 不足	adj.  负的； 不利的； 略低于某标准的；	
miracle	[ˈmɪrəkl]	n.  奇迹，圣迹，神迹； 令人惊奇的人（或事）；	
miserable	[ˈmɪzrəbl]	adj.  悲惨的； 令人痛苦的； 太少的； 卑鄙的	
mislead	[ˌmɪsˈli:d]	vt.  把…带错路； 把…引入歧途；	
missile	[ˈmɪsaɪl]	n.  导弹； 投射物；	adj.  导弹的； 可投掷的； 用以发射导弹的；	
missing	[ˈmɪsɪŋ]	adj.  失去的； 下落不明的；	v.  错过( miss的现在分词)；	
mission	[ˈmɪʃn]	n.  代表团； 使命； 官方使命； 布道所	v.  给…交代任务； 派遣； 把任务交给； 向…传教	
mist	[mɪst]	n.  薄雾； 视线模糊不清； 液体喷雾；	vt.  （使）蒙上薄雾； （使）模糊；	vi.  下雾； 变模糊；	
misunderstand	[ˌmɪsʌndəˈstænd]	vt.  误会，误解； 曲解；	
mixture	[ˈmɪkstʃə(r)]	n.  混合，混杂； 混杂的事物[人群]； 混合（状态）；	
mobile	[ˈməʊbaɪl]	adj.  可移动的； 行动自如的； 易变的； 流动性的	n.  风铃； 手机；	
moderate	[ˈmɒdərət]	adj.  有节制的； 稳健的，温和的； 适度的，中等的； 慢吞吞的	vt.  使和缓； 主持； 节制；	vi.  变缓和； 作主持人；	
modest	[ˈmɒdɪst]	adj.  谦虚的，谦逊的； 适度的，适中的； 端庄的； 羞怯的	
modify	[ˈmɒdɪfaɪ]	vi.  被修饰； 修改；	vt.  改变； 减轻，减缓； [语]修饰，（用变音符号）改变；	
moist	[mɔɪst]	adj.  潮湿的； 微湿的； 多雨的； 含泪的	
moisture	[ˈmɔɪstʃə(r)]	n.  水分； 湿气； 潮湿； 降雨量	
mold	[məʊld]	n.  模子； 模式； 类型； 霉	vt.  塑造； 浇铸； 用模子做； 用泥土覆盖	vi.  对…产生影响，形成； 发霉；	
molecule	[ˈmɒlɪkju:l]	n.  分子； 微小颗粒；	
monitor	[ˈmɒnɪtə(r)]	n.  显示屏，屏幕； [计]显示器； 监测仪； 监控人员，班长	vt.  监控，监听； 搜集，记录； 测定； 监督	vi.  监视；	
monument	[ˈmɒnjumənt]	n.  纪念碑； 遗迹； 遗址； 丰碑	
mood	[mu:d]	n.  心情； 语气； 气氛； 坏心境	
moral	[ˈmɒrəl]	adj.  道德的，道义上的； 精神上的； 无疑的，当然的； 教导道德的	n.  寓意，教训； （尤指男女间的）品行； 格言； 〈古〉相对者	
moreover	[mɔ:rˈəʊvə(r)]	adv.  再者； 此外； 而且； 同时	
mosquito	[məˈski:təʊ]	n.  蚊子；	
motion	[ˈməʊʃn]	n.  运动； 手势； 动机，意向； 请求	vt.  打手势； 向某人点头或摇头示意； 打手势要求[指示]；	vi.  运动； 打手势；	
motivate	[ˈməʊtɪveɪt]	vt.  使有动机，促动，激发，诱导； 刺激； 激发…的积极性；	
motive	[ˈməʊtɪv]	n.  动机，主旨； （艺术作品的）主题，题材；	adj.  运动的； 动机的； 发动的；	vt.  促使；	
motor	[ˈməʊtə(r)]	n.  马达，发动机，[火箭]助推器； 原动者，原动力； 汽车； [解]运动肌，运动神经	vi.  开[乘]汽车；	vt.  用汽车运送；	adj.  有引擎的； 由发动机推动的； 机动车的； 肌肉运动的	
mould	[məʊld]	n.  铸模； 模型； 性格； 霉	vt.  用模子做； 形成； 陶冶，训练（人格）； 用土覆盖	
mount	[maʊnt]	vt.& vi.  登上； 骑上；	vi.  增加； 上升；	vt.  安装，架置； 镶嵌，嵌入； 准备上演； 成立（军队等）	n.  山峰； 攀，登； 运载工具； 底座	
mud	[mʌd]	n.  泥，泥淖； 没价值的东西，污物； 咖啡； 诽谤的话	vt.  抹泥； 钻入泥中；	
mug	[mʌg]	n.  马克杯，杯子； 容易受骗的人； 脸； 一缸子（的量）	vt.  对…行凶抢劫； （尤指在舞台上或摄影机前）扮鬼脸，扮怪相；	
multiple	[ˈmʌltɪpl]	adj.  多重的； 多个的； 复杂的； 多功能的	n.  倍数； [电工学]并联； 连锁商店； 下有多个分社的旅行社	
multiply	[ˈmʌltɪplaɪ]	vt.& vi.  乘； （使）相乘； （使）增加； （使）繁殖	adv.  多样地； 复合地； 多倍地； [电学]并联地，多路地	adj.  多层的； 多样的； 多股的；	
murder	[ˈmɜ:də(r)]	n.  谋杀； 杀戮； 极艰难[令人沮丧]的经历；	vt.  凶杀； 糟蹋； 打垮；	vi.  杀人；	
muscle	[ˈmʌsl]	n.  肌肉； 力量； 权威，权力；	vt.  硬挤； 使劲搬动；	vi.  用力挤；	
museum	[mjuˈzi:əm]	n.  博物馆；	
mushroom	[ˈmʌʃrʊm]	n.  蘑菇； 蘑菇状物，蘑菇形物体； （女用）蘑菇形草帽； 暴发户	adj.  蘑菇的； 蘑菇形的； 迅速生长的； 雨后蘑菇似的	vi.  迅速增长； 采蘑菇； 迅速增加； （火）猛然的扩大	
musician	[mjuˈzɪʃn]	n.  音乐家；	
mutual	[ˈmju:tʃuəl]	adj.  共有的； 共同的； 相互的； 彼此的	
mysterious	[mɪˈstɪəriəs]	adj.  神秘的，诡秘的； 难以理解的，不可思议的； 魔； 玄妙	
mystery	[ˈmɪstri]	n.  秘密，谜； 神秘，神秘的事物； 推理小说，推理剧； 常作 mysteries 秘技，秘诀	
myth	[mɪθ]	n.  神话； 神怪故事； 奇人，奇事； 虚构的人，虚构的事	v.  使神话化；	
naked	[ˈneɪkɪd]	adj.  裸体的，裸露的； 率直的，赤裸裸的； 缺乏保护； 不加掩饰的	
namely	[ˈneɪmli]	adv.  即，也就是； 换句话说； 亦即； 就是说	
nationality	[ˌnæʃəˈnæləti]	n.  国籍； 国家； 民族性； 部落	
naturally	[ˈnætʃrəli]	adv.  自然地，表现自然地，顺理成章地； 合理地，当然，不用说； 生来，天然地； 自自然然，不做作地	
nature	[ˈneɪtʃə(r)]	n.  自然； 天性； 天理； 类型	
naval	[ˈneɪvl]	adj.  （有）海军的，军舰的，船的；	
navigation	[ˌnævɪˈgeɪʃn]	n.  航行（学）； 航海（术）； 海上交通；	
navy	[ˈneɪvi]	n.  海军； 船队；	
nearby	[ˌnɪəˈbaɪ]	adj.  在附近的，位于附近的；	adv.  附近地，不远地；	
necessarily	[ˌnesəˈserəli]	adv.  必要地； 必需地； 必定地； 必然地	
necessity	[nəˈsesəti]	n.  必要（性）； （迫切）需要； 必需品； 自然规律	
negative	[ˈnegətɪv]	adj.  消极的，否认的； [数]负的； [心]反抗性的； 无预期结果的	n.  否定词语； 否定的观点； 消极性； [摄]底片	vt.  否定； 拒绝；	
neglect	[nɪˈglekt]	vt.  疏忽； 忽略； 遗漏； 疏于照顾	n.  玩忽； 被忽略的状态； 怠慢；	
negotiate	[nɪˈgəʊʃieɪt]	vi.  谈判，协商，交涉；	vt.  谈判达成； 成功越过； 议价出售；	
Negro	[ˈni:grəʊ]	n.  黑种人，黑人；	adj.  黑人的；	
neighbourhood	[ˈneɪbəhʊd]	n.  居住区； 周边地区； 大约； 在…附近	
nephew	[ˈnefju:]	n.  侄子，外甥；	
nerve	[nɜ:v]	n.  神经； 勇气，胆量； [植] 叶脉； 中枢	vt.  鼓励，激励； 鼓起勇气；	
nest	[nest]	n.  （鸟）窝； 温床； （套叠在一起的）一套物件； 藏匿处	vt.  筑巢； 嵌套；	vi.  筑巢；	
network	[ˈnetwɜ:k]	n.  网； （电视与计算机）网络； 网状物； 广播网	vt.& vi.  将…连接成网络； 建立工作关系；	vt.  把（地方节目）编排到广播网（或电视网）联播； 使（全国）联播； （如）用网覆盖； 广泛分布	vi.  沟通，互助；	
neutral	[ˈnju:trəl]	adj.  中立的； （化学中）中性的； 暗淡的； 不带电的	n.  （汽车或其他机器的）空挡位置； 中立人士； 中立国； 素净色	
nevertheless	[ˌnevəðəˈles]	adv.  然而； 尽管如此； 不过； 仍然	conj.  然而； 尽管如此；	
niece	[ni:s]	n.  外甥女； 侄女；	
nightmare	[ˈnaɪtmeə(r)]	n.  噩梦； 可怕的事情，无法摆脱的恐惧； 泛滥成灾； 紧张	adj.  可怕的，噩梦似的；	
nitrogen	None	None	
nonsense	[ˈnɒnsns]	n.  胡说，废话； 荒谬的念头； 愚蠢的行为； 胡闹	adj.  无意义的； 荒谬的；	int.  荒唐；	
normal	[ˈnɔ:ml]	adj.  正常的； 正规的，标准的； [数学]正交的； 精神健全的	n.  正常，常态； 标准； [数学]法线；	
normally	[ˈnɔ:məli]	adv.  正常地； 通常地，一般地； 按说； 论理	
notebook	[ˈnəʊtbʊk]	n.  笔记簿； 笔记本电脑； 手册； 笔记本	
noticeable	[ˈnəʊtɪsəbl]	adj.  显而易见的，明显的； 引人注目的，令人瞩目的； 显著的，重要的； 可以察觉的	
notify	[ˈnəʊtɪfaɪ]	vt.  通知； 布告；	
notion	[ˈnəʊʃn]	n.  概念，观念； 意见，见解； 奇想； 打算	
nowhere	[ˈnəʊweə(r)]	adv.  任何地方都不，无处； 毫无结果；	n.  无处； 任何地方； 无名之地；	adj.  不存在的； 毫无结果的； 不知名的；	
nuclear	[ˈnju:kliə(r)]	adj.  原子核的，原子能的； [细胞]细胞核的；	
nucleus	None	None	
nuisance	[ˈnju:sns]	n.  讨厌的东西（人，行为）麻烦事； 非法妨害，损害； 麻烦事；	
poetry	[ˈpəʊətri]	n.  诗，诗歌； 诗意，诗情； 作诗； 诗歌艺术	
poison	[ˈpɔɪzn]	n.  毒药； 酒； 极糟的食物； 极有害的思想（或心情等）	vt.  毒死； 污染； 放毒于； 对…有不良影响	adj.  有毒的；	
poisonous	[ˈpɔɪzənəs]	adj.  有毒的； 有害的； 恶意的； 讨厌的	
pole	[pəʊl]	n.  [物]极点，顶点； 地极； 杆； 两极端	vt.& vi.  用篙撑船，摆船；	vt.  [航海] 用一根杆来推动； 以杆推进； 以杆支撑（植物）； 用杆子击打、戳、或搅拌	vi.  用滑雪杖加速；	
policy	[ˈpɒləsi]	n.  政策； 策略； 保险单； 策略性	
polish	[ˈpɒlɪʃ]	v.  擦光； 磨光； 修改； 润色	n.  光泽剂，擦亮剂； 擦亮，磨光； 优美，优雅，精良；	
politician	[ˌpɒləˈtɪʃn]	n.  政治家； 政客，玩弄权术者； 政客，政治贩；	
politics	[ˈpɒlətɪks]	n.  政治； 政治事务； 政治观点； 权术	
poll	[pəʊl]	n.  民意调查； 投票选举； 投票数；	v.  得到（一定数目的）选票； 对…进行民意调查；	
pollute	[pəˈlu:t]	vt.  污染； 玷污，亵渎； 破坏（品性），使堕落；	
pollution	[pəˈlu:ʃn]	n.  污染（作用）； 腐败； 堕落； 沾污	
pond	[pɒnd]	n.  池塘； （the pond） （非正式）大西洋；	v.  拦截（流水等液体）形成小湖；	
portable	[ˈpɔ:təbl]	adj.  手提的； 轻便的；	n.  手提式打字机；	
porter	[ˈpɔ:tə(r)]	n.  门童； 搬运工人； （医院里护送病人的）护工； （尤指卧铺车厢的）列车服务员	
portion	[ˈpɔ:ʃn]	n.  一部分； 一份遗产（或赠与的财产）； 嫁妆； 分得的财产	vt.  把…分成份额； 分配； 把…分给(to)； 命运注定	
portrait	[ˈpɔ:treɪt]	n.  肖像，肖像画； 模型，标本； 半身雕塑像； 人物描写	
pose	[pəʊz]	vt.& vi.  使摆姿势； 以…身份出现； 招摇； 炫耀	vt.  提出； 造成（威胁、问题等）； 引起； 产生	n.  姿势； 姿态； 装腔作势； 伪装	
positive	[ˈpɒzətɪv]	adj.  积极的； 确实的，肯定的； [数]正的； [医]阳性的	n.  正面； 正片； [语]原级形容词； [数]正量	
possess	[pəˈzes]	vt.  拥有； 掌握，懂得； 主宰； 缠住，迷住	
possession	[pəˈzeʃn]	n.  有，所有，拥有； 领地； 财产，所有权，占有物，所有物； 持有违禁物	
possibility	[ˌpɒsəˈbɪləti]	n.  可能，可能性； 希望，可能发生的事物；	
postage	[ˈpəʊstɪdʒ]	n.  邮费，邮资；	
postpone	[pəˈspəʊn]	vt.  使延期，延缓； 把…放在次要地位； 把…放在后面；	vi.  延缓； 延缓发作；	
potential	[pəˈtenʃl]	adj.  潜在的，有可能的； [语法学]可能语气的，表示可能性的； 有能力的；	n.  潜力，潜能； [物]电位，势能； 潜能的事物； [语]可能语气	
pour	[pɔ:(r)]	vt.  涌出； 倾，倒；	vi.  涌流； 泛滥，涌出； 斟，倒；	n.  倾泻；	
poverty	[ˈpɒvəti]	n.  贫穷； 缺乏，不足； 贫瘠，不毛； 低劣	
powder	[ˈpaʊdə(r)]	n.  粉，粉末； 粉状物质；	vt.  在…搽粉；	vi.  涂粉，变成粉末；	
powerful	[ˈpaʊəfl]	adj.  强大的； 权力大的； （药）有效地；	adv.  很； 非常；	
practically	[ˈpræktɪkli]	adv.  实际上； 几乎； 事实上；	
pray	[preɪ]	vt.  祈祷，祷告； 请求，恳求； 央求；	vi.  祈祷； 请； 恳求；	
prayer	[preə(r)]	n.  祈祷； 祈祷（习惯）； 祈祷文； 经文	
precaution	[prɪˈkɔ:ʃn]	n.  预防，防备，警惕； 预防措施； 避孕措施；	vt.  使提防； 预先警告；	
preceding	[prɪ'si:dɪŋ]	adj.  （时间或地点上）在先的，在前的，前面的； 前述的； 上述的；	v.  在…之前发生（或出现）； 走在…前面； 先于； “precede”的现在分词	
precious	[ˈpreʃəs]	adj.  宝贵的，珍贵的； 贵重的； 矫揉造作的； 可爱的，宝贝的	adv.  很，非常；	n.  珍爱的人； 可爱的人；	
precise	[prɪˈsaɪs]	adj.  清晰的； 精确的； 正规的； 精密	
precision	[prɪˈsɪʒn]	n.  精确度，准确（性）； [语]精确；	adj.  精确的，准确的，细致的； 严守标准的； 行动精确的；	
predict	[prɪˈdɪkt]	vt.  预言，预测； 预示，预告；	vi.  预言，预示：预言某事，预言；	
preface	[ˈprefəs]	n.  序言，引语； 开端，前奏； [宗]（弥撒的）序诵，序祷；	vi.&vt.  作为…的序言，作为…的开端； 作序； 给…作序； 开始，导致	
preferable	[ˈprefrəbl]	adj.  更好的，更可取的； 略胜一筹的；	
preference	[ˈprefrəns]	n.  偏爱； 优先权； 偏爱的事物； （债权人）受优先偿还的权利	
pregnant	[ˈpregnənt]	adj.  怀孕的； 孕育着…的； 富于想象的； 富于成果的	
prejudice	[ˈpredʒudɪs]	n.  成见，偏见，歧视； 侵害； 伤害；	vt.  使有偏见； 不利于，损害；	
preliminary	[prɪˈlɪmɪnəri]	adj.  初步的，初级的； 预备的； 开端的； 序言的	n.  准备工作； 预赛； 初步措施； （对学生等的）预考	
preparation	[ˌprepəˈreɪʃn]	n.  准备，预备； 准备工作； 配制品； 制剂	
preposition	[ˌprepəˈzɪʃn]	n.  介词； 前置词；	
prescribe	[prɪˈskraɪb]	vt.  指定，规定； 开处方，给医嘱；	vi.  建立规定，法律或指示；	
presence	[ˈprezns]	n.  出席，到场； 存在，出现； 风采，风度； 鬼魂，神灵	
presentation	[ˌpreznˈteɪʃn]	n.  提交； 演出； 陈述，报告； 颁奖仪式	
presently	[ˈprezntli]	adv.  目前； 不久； 马上；	
preserve	[prɪˈzɜ:v]	vt.  保护； 保持，保存； 腌制食物； 防腐处理	vi.  保鲜； 保持原状； 做蜜饯； 禁猎	n.  蜜饯； 防护用品； 禁猎地； 独占的事物（或范围）	
pressure	None	None	
presumably	[prɪˈzju:məbli]	adv.  据推测； 大概； 可能； 想来	
pretend	[prɪˈtend]	vt.  假装，伪装； 假称； 装扮；	vi.  扮演； 自称； 假装，矫作；	adj.  仿制的；	
prevail	[prɪˈveɪl]	vi.  流行，盛行； 获胜，占优势； 说服，劝说；	
previous	[ˈpri:viəs]	adj.  先前的； 以前的； 过早的； （时间上）稍前的	adv.  在先；在…以前；	
priest	[pri:st]	n.  神父，牧师； 司铎，司祭； 领导者； 神甫	vt.  使成为神职人员；	
primarily	[praɪˈmerəli]	adv.  首先； 首要地，主要地； 根本上； 本来	
primary	[ˈpraɪməri]	adj.  首要的，主要的； 最早的，原始的； [地质学]原生的； 基本的	n.  第一位； 最好者； 要素； 候选人提拔会	
prime	[praɪm]	adj.  最好的； 首要的； 最初的； 基本的	n.  精华； 初期； 全盛时期； 青年	vt.  使准备好； 填装； 事先指导；	adv.  极好地；	vi.  （为枪炮）装火药； 涂底漆； 修剪树枝； 注水入泵引起	
primitive	[ˈprɪmətɪv]	adj.  原始的； 发展水平低的； 落后的； [生物学]原生的	n.  原始人； 早期的艺术家（作品）； 单纯的人：不世故的人； 自学的艺术家	
principal	[ˈprɪnsəpl]	adj.  最重要的； 主要的； 资本的； 本金的	n.  校长； 主要演员，主角； [法]委托人，当事人； 本金	
principle	[ˈprɪnsəpl]	n.  原则，原理； 准则，道义； 道德标准； 本能	
prior	[ˈpraɪə(r)]	adj.  优先的； 占先的； 在…之前；	n.  小修道院院长，大修道院的副院长； （隐修院）会长； [史]行政长官； 普赖尔	adv.  在前； 居先；	
priority	[praɪˈɒrəti]	n.  优先，优先权； （时间，序上的）先，前； 优先考虑的事； [数]优先次序	
private	[ˈpraɪvət]	adj.  私有的，私人的； 秘密的； 内心的； 平民的，无官职的，士兵的	n.  列兵，士兵，[陆]二等兵； 〈古〉私人，个人； 阴部，生殖器；	
privilege	[ˈprɪvəlɪdʒ]	n.  特权； 特殊利益； 荣幸，光荣； 免责特权	vt.  给予特权； 特别优待；	
probable	None	None	
procedure	[prəˈsi:dʒə(r)]	n.  程序，手续； 工序，过程，步骤； 诉讼程序，（议会的）议事程序； 〈罕〉进行	
proceed	[prəˈsi:d]	vi.  进行； 前进； （沿特定路线）行进； （尤指打断后）继续说	n.  收入，获利；	
process	[ˈprəʊses]	n.  过程； 工序； 做事方法； 工艺流程	vt.  加工； 处理； 审阅； 审核	vi.  列队行进；	
procession	[prəˈseʃn]	n.  队伍，行列； 一列，一排； 列队行进；	vi.  排队前进或列队而行；	
product	[ˈprɒdʌkt]	n.  产品； 结果； 乘积； 作品	
profession	[prəˈfeʃn]	n.  职业，专业； 同行； 宣称； 信念，信仰	
professional	[prəˈfeʃənl]	adj.  专业的； 专业性的； 职业的；	n.  专业人士；	
profile	[ˈprəʊfaɪl]	n.  侧面，半面； 外形，轮廓； [航]翼型； 人物简介	vt.  描…的轮廓； 给…画侧面图； 为（某人）写传略； [机]铣出…的轮廓	
profit	[ˈprɒfɪt]	n.  收益，得益； 利润； 红利； 净值利润率	vt.  有益于…，对…有益的； 得益； 创利润；	vi.  有益； 获利；	
progressive	[prəˈgresɪv]	adj.  不断前进的； 进步的； 进行的；	n.  改革论者； 进步分子；	
prohibit	[prəˈhɪbɪt]	vt.  禁止，阻止，防止； 不准许；	
project	[ˈprɒdʒekt]	vt.  放映； 计划； 发射； 展现，使突出	vi.  伸出，突出；	
prominent	[ˈprɒmɪnənt]	adj.  突出的，杰出的； 突起的； 著名的；	
promote	[prəˈməʊt]	vt.  促进，推进； 提升，助长； 促销； 使（学生）升级 宣传，推广；	vi.  成为王后或其他大于卒的子；	
response	[rɪˈspɒns]	n.  反应； 回答，答复； [宗]回应经文，应唱圣歌；	
responsibility	[rɪˌspɒnsəˈbɪləti]	n.  责任； 职责； 责任感，责任心； 负责任	
responsible	None	None	
restless	[ˈrestləs]	adj.  焦躁不安的； 不耐烦的； 坐立不安的； 难以入睡的	
restore	[rɪˈstɔ:(r)]	vt.  归还； 交还； 使恢复； 修复	vt.& vi.  恢复（某种情况或感受）； 使复原； 使复位； 使复职	
restrain	[rɪˈstreɪn]	vt.  抑制，压抑； 限定，限制； 制止； 监禁	
restraint	[rɪˈstreɪnt]	n.  抑制，克制； 控制，限制； 拘束； 约束力	
restrict	[rɪˈstrɪkt]	vt.  限制，限定； 约束，束缚；	
result	[rɪˈzʌlt]	n.  结果； （尤指足球比赛的）胜利； [体]比分； 成功实现的事	vi.  发生，产生； 归结为，导致； 后果，终结； 由…而造成[产生]	
resume	[rɪ'zju:m]	vt.  （中断后）重新开始，继续；重新回到，恢复（席位，地位或职位）；（停顿或被打断后）继续说；重选，重穿，重新占用；	vi.  重新开始，继续；再次出现；	
retain	[rɪˈteɪn]	vt.  保持； 留在心中，记住； 雇用； 付定金保留	
retire	[rɪˈtaɪə(r)]	vi.  退休； 撤退； 后退，退却；	vt.  退休，退隐； 使撤退； 收回；	n.  退休； 退隐； 退兵信号；	
retreat	[rɪˈtri:t]	vi.  撤退，后退； 撤销，作罢； （眼睛等）凹进； [航]向后倾斜	n.  撤回； 静居处； 引退期间； 静思，静修	
reveal	[rɪˈvi:l]	vt.  显露； 揭露； 泄露； [神]启示	n.  揭示，展现； [建]门侧，窗侧；	
revenue	[ˈrevənju:]	n.  （国家的）岁入，税收，（土地，财产等的）收入，收益，所得，（个人的）固定收入； [复数]总收入； 税务署，〈美俚〉税务官； 税务局	
reverse	[rɪˈvɜ:s]	vt.& vi.  （使）反转； （使）颠倒； 调换，交换； [法]撤消，推翻	vi.  倒退； [桥牌]逆叫；	adj.  反面的； 颠倒的； 倒开的； [生]倒卷的	n.  倒转，反向； [机]回动； 倒退； 失败	
revise	[rɪˈvaɪz]	vt.  修订； 改变； 修正； [主英国英语]复习	vt.& vi.  复习；	vi.  修订，校订；	n.  修订； 校订； [印刷]校样，清样； 修订版，修订本	
revolt	[rɪˈvəʊlt]	vt.  （使）厌恶；	vi.  反叛，背叛； 厌恶，反感；	n.  造反，起义；	
revolutionary	[ˌrevəˈlu:ʃənəri]	adj.  革命的； 革命性的，创新的； 旋转的；	n.  革命者，革新者；	
reward	[rɪˈwɔ:d]	n.  报酬； 报答； 赏金； 酬金	vt.  酬谢，奖赏； 报答，惩罚；	
rhythm	[ˈrɪðəm]	n.  [诗]节奏，韵律； [医]节律，规律； [乐]节拍； [艺]调和	
rib	[rɪb]	n.  肋骨； （船或屋顶等的）肋拱； 肋骨状的东西； （织物的）凸条花纹	vt.  嘲笑，逗弄，开（某人的）玩笑； 装肋于，给…装肋材；	
ribbon	[ˈrɪbən]	n.  带，缎带，带状物； （打印机的）色带； （勋章等的）绶带；勋表；	vi. .  形成带状；	vt.  把…撕成条带；用缎带装饰；	
rid	[rɪd]	vt.  使摆脱，解除，免除；	
ridge	[rɪdʒ]	n.  背脊，峰，隆起线； 山脊，山脉，海脊； 高压脊； 皱摺，田埂	vt.  使成脊状，使隆起；	vi.  使成脊状；	
ridiculous	[rɪˈdɪkjələs]	adj.  可笑的，荒谬的； 荒唐的，愚蠢的； 胡枝扯叶；	
rifle	[ˈraɪfl]	n.  步枪； 来福枪；	vt.& vi.  快速搜寻； 匆忙翻找 ； 偷窃； 盗取	
rigid	[ˈrɪdʒɪd]	adj.  严格的； 僵硬的； （规则、方法等）死板的； 刚硬的，顽固的	
riot	[ˈraɪət]	n.  骚乱，暴动，暴乱，骚动，混乱； 放荡，闹饮，嘈闹的宴会，喝酒狂闹； 五色缤纷，喧嚣嘈杂； （想像，感情等的）奔放	vi.  暴动，闹事； 放荡；	vt.  浪费； 挥霍；	
ripe	[raɪp]	adj.  成熟的； 醇美可口的； 老练的； 时机成熟的	v.  〈诗〉同“ripen“；	
risk	[rɪsk]	n.  危险，冒险； 保险额； 被保险人或物；	vt.  冒…的危险； 使…冒风险（或面临危险）；	
rival	[ˈraɪvl]	n.  对手； 竞争者；	vt.  与…竞争； 比得上某人；	vi.  竞争；	adj.  竞争的；	
roar	[rɔ:(r)]	vi.  咆哮； 喧闹； 吼叫； 混乱或吵闹	vt.  大声喊出； 使…轰鸣； 吼，咆啸；	n.  吼叫声，咆哮声，呼啸声； 狂笑，大笑；	
roast	[rəʊst]	vt.& vi.  烤，烘，焙；	vt.  嘲讽，挖苦；	n.  烤肉； 户外烧烤野餐；	adj.  烤好的，烤制的；	
rob	[rɒb]	vt.  抢劫，掠夺；（非正式）敲诈；（非正式）盗窃；使…丧失，非法剥夺；（英足）夺（对手）的球；	vi.  抢劫； 掠夺；	
rocket	[ˈrɒkɪt]	n.  火箭； 火箭发射器； 火箭发动机； 芝麻菜	vi.  飞快地移动； 急速上升；	vt.  用火箭运送； 用火箭攻击；	
rod	[rɒd]	n.  杆，拉杆； 惩罚，体罚； （责打人用的）棍棒； 手枪	
roller	[ˈrəʊlə(r)]	n.  滚筒； 滚压机； 定型卷夹，塑料发卷； 巨浪	
romantic	[rəʊˈmæntɪk]	adj.  浪漫的，谈情说爱的，多情的，风流的，香艳的； 空想的，虚构的，怪诞的，想入非非的，不实际的，难实行的（计划等）； 传奇（式）的，小说般的，情节离奇的； 浪漫主义的	n.  富于浪漫气息的人； 浪漫主义作家[画家等]，浪漫派诗人[艺术家]； 浪漫思想[行为]；	
rope	[rəʊp]	n.  粗绳； 绳索； 一串； 学会决窍，知道决窍	vt.  （用绳子）捆； 用绳子系牢； 捆紧； 用套索抓捕（动物）	vi.  成索状或绳状；	
rotate	[rəʊˈteɪt]	vt.& vi.  （使某物）旋转； 使转动； 使轮流，轮换； 交替	adj.  [植]辐状的； 有辐射部分的；	
rotten	[ˈrɒtn]	adj.  腐烂的； 恶臭的； 堕落的； 极坏的	adv.  非常； 极其；	
rouse	[raʊz]	v.  叫醒，惊醒； 鼓励，鼓舞； 使发脾气； 使振奋	n.  觉醒； 奋起； [军]起床号； 干杯	vi.  醒来； 奋起；	
route	[ru:t]	n.  路； （公共汽车和列车等的）常规路线； 航线； 渠道，途径	vt.  按某路线发送； 给…规定路线[次序，程序]；	
routine	[ru:ˈti:n]	n.  常规； 例行程序； 生活乏味； （演出中的）一套动作	adj.  例行的； 常规的； 日常的； 普通的	
royal	[ˈrɔɪəl]	adj.  王国的，王室的； 高贵的，庄严的； 盛大的； 敕许的，敕定的	n.  王室成员； [航海]顶桅帆；	
rub	[rʌb]	vt.  擦，摩擦； 用…擦； 触怒； （使）相互磨擦	vi.  接触，摩擦； 擦伤； 在困境中持续下去；	n.  摩擦的动作； 表面不平； 阻碍，困难；	
rude	[ru:d]	adj.  粗鲁的； 简陋的； 狂暴的； 近乎下流的	
rug	[rʌg]	n.  小块地毯； 〈英〉（围盖膝的）围毯，车毯； 〈美俚男子假发；	
ruin	[ˈru:ɪn]	vt.  破坏，毁灭； 使破产； 使没落，使堕落； 变成废墟	n.  毁灭，灭亡； 废墟，遗迹； [灭亡]的原因，祸根； 损失	vi.  被毁灭； 破产； 堕落；	
rumour	[ˈru:mə(r)]	n.  传闻，谣言； 流言；	vt.  谣传；	
rural	[ˈrʊərəl]	adj.  乡下的，农村的； 田园的； 地方的； 农业的	
rust	[rʌst]	n.  铁锈； 锈病，锈菌； 荒废，停滞； 锈，锈色	vt.& vi.  （使）生锈； [植]害锈病； 变钝，荒废；	
sack	[sæk]	n.  麻袋； 洗劫； 解雇；	vt.  解雇； 把…装进袋里； 掠夺；	
sacrifice	[ˈsækrɪfaɪs]	n.  牺牲； 献祭，供奉； 牺牲行为； [宗]基督的献身	vt.& vi.  牺牲，把…奉献给…； 廉价卖出； 牺牲，献祭； [棒]作牺牲打	vt.  献祭； 奉献； 牺牲； 亏本出售	
saddle	[ˈsædl]	n.  马鞍； （自行车或摩托车的）车座； 鞍形架，鞍状物； （动物的）脊肉	vt.& vi.  给（马）装鞍；	vt.  使承担；	
sailor	[ˈseɪlə(r)]	n.  水手，海员； 驾船人；	
saint	[seɪnt]	n.  圣人般的人（指特别善良、仁爱或有耐性的人）； 圣…（冠于人名、地名之前）； （因其生死言行而被基督教会追封的）圣人； 圣徒	vt.  成为圣徒； 把…视为圣徒；	
sake	[seɪk]	n.  缘故； 理由； 日本米酒； 目的	
salad	[ˈsæləd]	n.  沙拉，色拉；尤指莴苣；	
salary	[ˈsæləri]	n.  薪水，薪金，薪俸；	vt.  给…加薪； 给…薪水； 发…薪水； 付…薪水	
salesman	None	None	
sample	[ˈsɑ:mpl]	n.  样品； 样本； （化验的）取样； （用于新乐曲中的）节录乐曲 确定（模拟信号）瞬时值；	vt.  品尝； 体验； 抽样调查； 取样 品尝，体验；抽样检验；节录（某一曲子，用于新乐曲中）；	adj.  样品的，作为例子的；	n.  （Sample） （美、英、爱尔兰）桑普尔（人名）；	
sanction	[ˈsæŋkʃn]	n.  制裁，处罚； 批准，认可； 约束力； 鼓励	vt.  批准； 鼓励，容忍；	
satellite	[ˈsætəlaɪt]	n.  卫星； 人造卫星； 卫星国； 卫星区	v.  通过通讯卫星播送[传播]；	
satisfactory	[ˌsætɪsˈfæktəri]	adj.  令人满意的； 符合要求的； [神]赎罪的；	
sauce	[sɔ:s]	n.  调味汁； 酱汁； 〈非〉莽撞无礼； 〈俚〉烈酒	vt.  调味或加沙司于…； 给…增加趣味或风味； 〈非〉对…无礼；	
saucer	[ˈsɔ:sə(r)]	n.  茶杯托，茶碟； （放花盆的）垫盘（等）； 浅碟形盆地； 〈美〉拳击场	
sausage	[ˈsɒsɪdʒ]	n.  香肠，腊肠； 〈口〉德国人；	
saving	[ˈseɪvɪŋ]	n.  节约； 节俭； 储蓄金； 挽救	v.  拯救( save的现在分词)； 收集； 保留； 避免	prep.  除…以外；	adj.  可取的，保存的； 节省的，节约的； 补偿的； 救助的	
scale	[skeɪl]	n.  规模； 比例（尺）； 鱼鳞； 级别 刻度；天平；数值范围；	v.  攀登；衡量；剥落； 刮去…的鳞片； 改变…大小； 刮除牙石 生水垢；	
scan	[skæn]	vt.  扫描； 细看； 细查； （雷达）对…进行扫描	n.  扫描； 浏览； 审视； （雷达）（屏面上的）光点	vi.  （光束、雷达等）扫描； 扫略； （诗歌）符合韵律； 标出诗歌的格律	
scandal	[ˈskændl]	n.  丑闻，丑名，丑事，丑行，丢脸的事件，舞弊案件，耻辱； 流言蜚语； 闲话； 诽谤	
scarce	[skeəs]	adj.  缺乏的，罕见的；	adv.  勉强； 仅仅； 几乎不； 简直不	
scarcely	[ˈskeəsli]	adv.  几乎不，简直不； 刚刚，才； 决不； （刚）一…就	
scare	[skeə(r)]	vt.  使惊恐，惊吓； 使害怕，使恐惧； 把…吓跑；	vi.  受惊吓； 感到害怕；	n.  惊恐，惊吓； 恐惧； 恐慌；	adj.  骇人的，令人恐惧的； 引起恐慌的； 用以吓唬人的；	
scatter	[ˈskætə(r)]	vt.  （使）散开，（使）分散，驱散；	vi.  撒开； 分散；	n.  撒布，散播；	
scenery	[ˈsi:nəri]	n.  风景，景色； 舞台布景； 风景画； 舞台面	
schedule	[ˈʃedju:l]	n.  时刻表，进度表； 清单，明细表； 预定计划； 目录	vt.  排定，安排； 将…列表； 为…作目录；	
scheme	[ski:m]	v.  密谋，图谋； 认为；	n.  计划； 方案； 阴谋； 体系	
scholar	[ˈskɒlə(r)]	n.  奖学金获得者； 学者； 聪颖勤奋的学生； 〈俚〉有文化的人，有某种文科知识的人	
stir	[stɜ:(r)]	vt.& vi.  （使）移动； 搅拌； （使）行动； （使）微动	vt.  使打起精神； 使奋起； 叫醒； 唤起	vi.  苏醒； 奋起； 传播； 发生	n.  搅动； 骚乱； 激动； 微动	
stock	[stɒk]	n.  股份，股票； 库存； 树干； 家畜	adj.  常备的，存货的； 陈旧的；	vt.  提供货物； 备有；	vi.  出新芽； 囤积；	
stocking	[ˈstɒkɪŋ]	n.  长袜； 似长袜之物；	
stoop	[stu:p]	n.  门廊，游廊； 自贬； 弯腰，驼背； 屈服	vt.& vi.  屈服，忍辱； 弯腰； 倾斜； 自贬	
storage	[ˈstɔ:rɪdʒ]	n.  贮存； 贮藏； 储藏处，仓库； 贮存器，蓄电（瓶）	
stove	[stəʊv]	n.  炉，火炉； 窑； 干燥室，烘房；	v.  用火炉烤；	
strain	[streɪn]	n.  压力； 拉力，张力； 拉伤，扭伤； 个性特点	vt.  拉伤，损伤； 尽力，竭力； 使不堪承受； 过滤	vi.  拉紧； 用力拉； 尽力，竭力；	
strap	[stræp]	v.  用带捆扎； 用皮带抽打； 拼命工作；	n.  带子； 皮带； 磨刀皮带； 鞭打	
strategic	[strəˈti:dʒɪk]	adj.  战略（上）的； 战略性的； 有战略意义的； 至关重要的	
strategy	[ˈstrætədʒi]	n.  策略，战略； 战略学；	
straw	None	None	
stream	[stri:m]	n.  河流，小河，川，溪； 潮流，趋势，倾向； （事件等的）连续，（财富等的）滚滚而来； 流出，流注，一连串	vt.& vi.  流，流动；	vi.  飘扬； 招展； 鱼贯而行； 一个接一个地移动	vt.  按能力分班（或分组）； 按能力分班（或分组）；	
strengthen	[ˈstreŋθn]	vt.  加强，巩固； 勉励，激励； 增加…的艺术效果； （价格）上涨	vi.  变强； 变坚挺；	
stress	[stres]	n.  强调； 重音； 压力； 重力	vt.  重读； [机械学]使承受压力； 给…加压力（或应力）；	
stretch	[stretʃ]	v.  伸展； 延伸； 持续； 包括	n.  伸展； 弹性； 一片； 一段时间	adj.  可伸缩的； 弹性的；	
striking	[ˈstraɪkɪŋ]	adj.  显著的； 引人注目的； 容貌出众的； 妩媚动人的	v.  打( strike的现在分词)； 击； 敲响； 报时	
string	[strɪŋ]	n.  绳子，带子； 线丝，植物纤维； 串； [计算机科学]字符串	vt.  上弦，调弦； 使排成一行或一系列； 绑，系或用线挂起； 延伸或扩展	
strip	[strɪp]	vi.  剥光； 表演脱衣舞； 剥除；	vt.  除去，剥去； 剥夺； 删除； 清除，拆除	n.  长条，条板； 带状地带（或森林、湖面等）； （足球队员的）运动服；	
stripe	[straɪp]	n.  条纹； 种类； 军士军阶； 犯人穿的横条囚衣	vt.  使带有条纹；	
stroke	[strəʊk]	n.  一击； 击球； 划水动作； 中风	vt.  划掉； 轻抚； 轻触； 敲击	vi.  击球； 作尾桨手，指挥划桨；	
structure	[ˈstrʌktʃə(r)]	n.  结构； 构造； 建筑物； 体系	vt.  构成，排列； 安排；	
studio	[ˈstju:diəʊ]	n.  工作室，画室； [影]演播室，电影制片厂；	
stuff	[stʌf]	n.  材料，原料，资料； 〈俚〉钱，现金； 填充物； 素材资料	vt.  塞满； 填塞； 让吃饱；	vi.  吃得过多；	
subject	[ˈsʌbdʒɪkt]	n.  主题，话题； 学科，科目； [哲]主观； 实验对象	adj.  须服从…的； （在君主等）统治下的；	v.  提供，提出； 使…隶属；	
submerge	[səbˈmɜ:dʒ]	vt.& vi.  淹没； 把…浸入； 沉没，下潜； 使沉浸	vt.  淹没； 把…浸入； 沉浸；	vi.  淹没； 潜入水中； 湮没；	
submit	[səbˈmɪt]	vi.  顺从，服从； 甘受，忍受；	vt.  使服从，使顺从； 提交，呈送； [法]主张，建议；	
subsequent	[ˈsʌbsɪkwənt]	adj.  后来的； 随后的； 作为结果而发生的； 附随的	
substance	None	None	
substantial	[səbˈstænʃl]	adj.  大量的； 结实的，牢固的； 重大的；	
substitute	[ˈsʌbstɪtju:t]	vt.& vi.  代替，替换，代用；	n.  代替者； 替补（运动员）； 替代物； [语法学]代用词	vi.  用…替代；	
subtract	[səbˈtrækt]	vt.  减去； 扣除；	
suburb	[ˈsʌbɜ:b]	n.  郊区，城郊； 边缘； 附近，周围；	
subway	[ˈsʌbweɪ]	n.  地铁； 地下通道；	
succession	[səkˈseʃn]	n.  继承人，继承权； 继承顺序； [生]自然演替； 一系列，接连	
successive	[səkˈsesɪv]	adj.  连续的，相继的； 继承的，接替的； 逐次；	
suck	[sʌk]	vt.  吮吸； 吸入； 卷进入； 吸取	vi.  舐，吮吸； 吸入； 通过吸吮的动作产生声音； 巴结	n.  吮吸； 吸力； 吸入物；	
suffer	[ˈsʌfə(r)]	vi.  受痛苦； 受损害； 变糟； 变差	vt.  忍受； 容忍； 容许； 遭受	
sufficient	None	None	
suggestion	[səˈdʒestʃən]	n.  建议，意见，暗示； 联想，启发； 微量；	
suicide	[ˈsu:ɪsaɪd]	n.  自杀； 自杀者； 自杀行为；	adj.  自杀的；	
sum	[sʌm]	n.  总数； 算术； 金额； 概略，要点	vt.& vi.  总计； 总结，概括； 归纳；	
summarize	[ˈsʌməraɪz]	vt.  总结，概述；	
summary	[ˈsʌməri]	n.  摘要，概要； 总结，一览；	adj.  概括的，总结的； 即刻的，立即的；	
summit	None	None	
sunlight	[ˈsʌnlaɪt]	n.  阳光；	
sunrise	[ˈsʌnraɪz]	n.  日出（时分），黎明； 日出的地方，东方；	
sunset	[ˈsʌnset]	n.  日落（时），薄暮； 晚霞； 黄昏；	adj.  定期废止的；	
sunshine	[ˈsʌnʃaɪn]	n.  阳光，日光； 晴朗，晴天； 太阳晒着的地方； 欢乐	
superb	[su:ˈpɜ:b]	adj.  极好的； 华丽的； 丰盛的，豪华的； 杰出的	
superficial	[ˌsu:pəˈfɪʃl]	adj.  表面（上）的； 肤浅的，缺乏深度的； 一知半解的；	
superior	[su:ˈpɪəriə(r)]	adj.  （级别、地位）较高的； （在质量等方面）较好的； （数量）较多的； 上等的	n.  上级； 较好的人[事物]，优胜者； 修道院院长； 方丈	
supplement	[ˈsʌplɪmənt]	vt.  增补，补充；	n.  增补，补充； 补充物； 增刊，副刊；	
supply	[səˈplaɪ]	vt.  供给； 补充； 弥补（缺陷、损失等）； 向…提供（物资等）	n.  供给物； 储备物质； 粮食；	vi.  暂代他人职务；	
support	[səˈpɔ:t]	vt.  支持； 帮助； 支撑； 维持	n.  支撑； 支持者； [数学]支集； 支撑物	
suppose	[səˈpəʊz]	vt.  假定； 猜想，推测； 认为； 让（用于祈祷语气）	vi.  想象，猜想；	
supreme	[su:ˈpri:m]	adj.  最高的； 至高的，无上的； 最重要的； （程度）很大的	
surgery	[ˈsɜ:dʒəri]	n.  外科学，外科手术； 手术室； 诊所； 诊断时间	
surplus	[ˈsɜ:pləs]	adj.  过剩的； 多余的；	n.  剩余额； 公积金； 顺差； 盈余	
surrender	[səˈrendə(r)]	vi.  投降； 屈服； 自首；	vt.  使投降； 放弃； 交出； 听任	n.  投降； 放弃； 屈服； （保险的）解约	
surround	[səˈraʊnd]	vt.  包围，围绕；	n.  （物品的）边； 外围物；	
surrounding	[səˈraʊndɪŋ]	n.  环境，周围的事物；	adj.  周围的，附近的；	v.  包围( surround的现在分词 )； 与…紧密相关； 围绕； 喜欢结交（某类人）	
survey	[ˈsɜ:veɪ]	vi.  测量土地；	vt.  调查； 勘测； 俯瞰；	n.  调查（表），调查所，测量，测量部，测量图； 概观，检查，鉴定书； 环顾；	
survival	[səˈvaɪvl]	n.  幸存，生存； 幸存者； 遗物； 遗风	
survive	[səˈvaɪv]	vi.  幸存，活下来；	vt.  比…活得长，经历…之后还存在； 幸存；	vt.& vi.  幸免于难； 挺过； 艰难度过；	
suspect	[səˈspekt]	vt.  猜疑（是）； 怀疑，不信任； 怀疑…有罪；	n.  嫌疑犯；	vi.  怀疑；	
suspend	[səˈspend]	v.  暂停； 延缓； 挂； 悬	
suspicion	[səˈspɪʃn]	n.  怀疑； 嫌疑； 疑心； 〈口〉一点儿	vt.  怀疑；	
sustain	[səˈsteɪn]	vt.  维持； 支撑，支持； 遭受，忍受； 供养	
swallow	[ˈswɒləʊ]	vt.& vi.  吞，咽； 忍耐，忍受；	vt.  不流露； 忍受，轻信；	n.  [鸟]燕子； 胃管，食道； 一次吞咽的量； （滑车等的）通索孔	
sway	[sweɪ]	vi.  摇摆； 歪，倾斜； 改变；	vt.  使前后或来回摇摆； 使倾斜； [航海]升起桅杆；	n.  摇摆； 支配，统治；	
swear	[sweə(r)]	v.  发誓； 咒骂；	n.  发誓，宣誓； 咒骂；	
swell	[swel]	vt.& vi.  增强； 肿胀； 膨胀； 充满（激情）	n.  汹涌； 重要人士； （尤指身体部位）凸起的形状； 声音渐强	adj.  极好的； 了不起的； 非常棒的；	
swift	[swɪft]	adj.  迅速的； 敏捷的； 立刻的； 突然发生的	n.  雨燕； 环球金融同业电讯会； [人]斯威夫特，《格利佛游记》作者；	adv.  迅速地，敏捷地；	
swing	[swɪŋ]	vt.& vi.  （使）摇摆； （使）摇荡；	n.  摇摆，摆动； 摆程，振幅； 秋千； 音律	vt.  使旋转； 使做曲线运动； 挥舞； 悬吊	vi.  悬摆； 迅速打击； 侧转，转弯； 轻快摇摆地走	
switch	[swɪtʃ]	n.  开关； 转换，转换器； 软鞭子； [信]接线台	vt.& vi.  转变，改变； 转换； 关闭电流； 鞭打	vt.  转换； 挥动（棍棒、鞭子等）； 迅速转动； 鞭打	vi.  交换； 调换；	
sword	[sɔ:d]	n.  剑，刀； 武力，战争； 兵权，权力；	
symbol	[ˈsɪmbl]	n.  象征； 标志； 符号； 记号	vt.  用符号代表；	
sympathetic	[ˌsɪmpəˈθetɪk]	adj.  同情的，有同情心的； 赞同的； 相投合的，称心的； 〈口〉抱好感的	
sympathize	[ˈsɪmpəθaɪz]	vi.  同情，怜悯； 共鸣，同感； 支持，赞成； 安慰	
sympathy	[ˈsɪmpəθi]	n.  意气相投，同感； 同情，同情心； 慰问； 和谐的一致	
symptom	[ˈsɪmptəm]	n.  症状； 征兆；	
veteran	[ˈvetərən]	n.  经验丰富的人，老兵； 退伍军人；	adj.  有作战经验的； 老兵的； [美国英语]退伍军人的； 老练的，资深的，经验丰富的	
via	[ˈvaɪə]	prep.  经过； 通过，凭借； 取道；	
vibrate	[vaɪˈbreɪt]	vt.& vi.  （使）振动[颤动]； 摆动； 犹豫； 激动	
vice	[vaɪs]	n.  恶习； 不道德行为； （肉体的）缺陷，疾病； （文体等的）缺点，瑕疵	prep.  代替； 取代；	adj.  副的； 代替的；	vt.  用老虎钳夹紧； 钳制；	
victim	[ˈvɪktɪm]	n.  牺牲者，受害者； 自找苦吃的人； 受骗者，上当者； 为祭祀杀死的动物（或人）	
video	[ˈvɪdiəʊ]	n.  磁带录像； 录像磁带； 录像机，电视； （指方法）录像	adj.  电视的； 视频的； 影像的； 用录像磁带[录像带]的	vt.  录像； 制作…的录像；	
viewpoint	[ˈvju:pɔɪnt]	n.  观点，意见，角度； 视角； 视点；	
vigorous	[ˈvɪgərəs]	adj.  有力的； 精力充沛的； 充满活力的； 朝气蓬勃的	
vinegar	None	None	
violate	[ˈvaɪəleɪt]	vt.  违反； 妨碍； 侵犯； 亵渎，强奸	
violence	[ˈvaɪələns]	n.  暴力，强暴，暴虐； 猛烈，激烈； 歪曲（事实），曲解（意义）； 冒渎，不敬	
violet	[ˈvaɪələt]	n.  紫罗兰； 蓝紫色，紫罗兰色； 堇菜； 羞怯的人	adj.  蓝紫色的； 紫罗兰色的；	
violin	[ˌvaɪəˈlɪn]	n.  小提琴； 小提琴手；	
virtual	[ˈvɜ:tʃuəl]	adj.  实质上的，事实上的； （计算机）虚拟的；	
virtually	[ˈvɜ:tʃuəli]	adv.  实际上，实质上，事实上，几乎； 无形中； 无形；	
virtue	[ˈvɜ:tʃu:]	n.  美德； 德行； 价值； 长处	
virus	[ˈvaɪrəs]	n.  病毒； 病毒性疾病； 毒素，毒害； [计算机科学]计算机病毒	
visible	[ˈvɪzəbl]	adj.  看得见的； 明显的，显然的； 手头的，可得到的； 可察觉到的	
vision	[ˈvɪʒn]	n.  视力，视觉； 想象； 幻象； 想象力	
visual	[ˈvɪʒuəl]	adj.  视觉的，看得见的； 光学的，视力的； 形象化的； 光学的	n.  画面，图象；	
vital	[ˈvaɪtl]	adj.  维持生命所必需的； 至关重要的； 生死攸关的； 生机勃勃的	
vitamin	[ˈvɪtəmɪn]	n.  维生素； 维他命；	na.  “vitamine“的变体；	
vivid	[ˈvɪvɪd]	adj.  生动的； （记忆、描述等）清晰的； （人的想像）丰富的； （光、颜色等）鲜艳的，耀眼的	
vocabulary	[vəˈkæbjələri]	n.  （某一语言的）词汇； （尤指外语教科书中附有释义的）词汇表；	
volcano	[vɒlˈkeɪnəʊ]	n.  火山；	
volt	[vəʊlt]	n.  伏特； [马术]环骑； [剑]闪避；	
voltage	[ˈvəʊltɪdʒ]	n.  电压，伏特数；	
volume	[ˈvɒlju:m]	n.  量，大量； 体积； 音量； 卷	adj.  大量的；	vi.  成团卷起；	vt.  把…收集成卷；	
voluntary	[ˈvɒləntri]	adj.  自愿的，自发的； 志愿的； 故意的，有意的； [法]无偿的	n.  自愿者； 自愿行动； 即兴演奏，自选节目； 自愿地做的工作	
volunteer	[ˌvɒlənˈtɪə(r)]	n.  志愿者； 自告奋勇者； 志愿兵；	v.  自愿做； 义务做； 主动建议； 自愿参军	
vote	[vəʊt]	v.  投票，选举； 提议； 投票表决； 公认，由舆论决定	n.  投票，表决； 投票数； 投票权； 决议	
wagon	[ˈwægən]	n.  四轮的运货马车； 铁路货车； 小手推车； 囚车	vt.  用运货马车运输货物；	na.  “waggon”的变体；	
waist	[weɪst]	n.  腰，腰部； （衣服的）腰身； 船腰； （女人，小孩子的）背心	
waken	[ˈweɪkən]	vi.  醒来； 睡醒； 觉醒；	vt.  唤醒，弄醒； 使觉醒；	vt.& vi.  （使）觉醒； （使）振奋； 激发；	v.  振起，鼓励；	
wander	[ˈwɒndə(r)]	vt.  漫步，漫游；	vi.  游荡，漫游，闲逛，慢走，漫步； 离开原路，离群，失散； （道路或河流）蜿蜒曲折； （人的思想等）走神，胡思乱想	n.  游荡； 溜达； 闲逛； 失散	
warmth	[wɔ:mθ]	n.  温暖，暖和； 热情，热心； 激动； 诚恳	
waterproof	[ˈwɔ:təpru:f]	adj.  不透水的，防水的； 用防水材料处理过的；	vt.  使防水，使不透水； 给（布）上胶；	n.  防水衣物，雨衣 usually plural； 防水布，油布； 防水物，防水材料；	
wax	[wæks]	n.  蜡，蜡状物； 耳垢，耳屎； （鞋匠用的）擦线蜡； 增大	vt.  给…打蜡，给…上蜡； 渐渐变大； 变为； （月亮）渐圆，渐盈	vi.  给…上蜡，给…涂蜡； 把…灌制唱片； 用热蜡除去毛发；	adj.  蜡制的，似蜡的；	
weaken	[ˈwi:kən]	vt.& vi.  （使）削弱； （使）变弱； 衰减； 变得优柔寡断	
wealth	[welθ]	n.  财产，财富； 富豪（阶级）； 丰富，大量； 繁荣	
wealthy	[ˈwelθi]	adj.  富有的； 充分的；	n.  富人，有钱人，阔人；	
weapon	[ˈwepən]	n.  武器，兵器；	vi.  武装，提供武器；	
weave	[wi:v]	vt.& vi.  编，织； 迂回行进； 穿行（以避开障碍）；	vt.  编排； （把…）编成；	vi.  纺织，织布；	n.  织物； 织法，编法； 编织式样；	
weed	[wi:d]	n.  杂草； 大麻； 废物； 烟草	vt.  给…除杂草； 除（草）； 消除；	vi.  除草；	
weekly	[ˈwi:kli]	adj.  一周一次的[地]，每周的； 周刊的；	n.  周刊，周报；	adv.  一星期一次，每周；	
weep	[wi:p]	vt.& vi.  （通常因悲伤）哭泣； 流泪； 悲哀； 哀悼	vi.  （伤口）流血，渗出水汽；	n.  一段哭泣，一阵哭泣；	
weld	[weld]	vt.& vi.  焊接； 使紧密结合；	n.  焊接点； 黄色植物染料；	
welfare	[ˈwelfeə(r)]	n.  福利； 幸福； 繁荣； 安宁	
well-known	['wel'nəʊn]	adj.  出名的，众所周知的，熟悉的； 鼎鼎大名； 闻；	
whale	None	None	
whatsoever	[ˌwɒtsəʊ'evə]	adv.  无论什么； 任何；	adj.  无论怎样；	
whereas	[ˌweərˈæz]	conj.  鉴于； 然而； 反之；	n.  “鉴于…”：正式文件的介绍性陈述，开场白； 条件性陈述；	
whichever	[wɪtʃˈevə(r)]	pron.  任何一个； 无论哪个； 究竟哪一个；	adj.  究竟哪个，无论哪些； 无论哪一个；	
whilst	[waɪlst]	conj.  同时； 时时，有时； 当…的时候； 同“while”	
whip	None	None	
whisper	[ˈwɪspə(r)]	vt.  低声说； 私语； 密谈，密谋坏事； 私下说	vi.  沙沙地响； 耳语； 密谈；	n.  低语，耳语； 飒飒声； [医]嗫音； 传闻	
whistle	[ˈwɪsl]	vi.  吹口哨，吹哨子，鸣汽笛； 呼啸； （动物）发出刺耳的叫声； 吹口哨召唤	vt.  由吹口哨而发出； 吹口哨召唤； 用哨声使…行动；	n.  口哨，哨子； 汽笛； 哨声，笛声； 啭鸣声：尖厉高音	
whoever	[hu:ˈevə(r)]	pron.  （引导名词性从句）谁； 无论谁，任何人； 不管谁…；	
wholly	[ˈhəʊlli]	adv.  完全地，全部地； 十足，统统； 专门； 一并	
wicked	None	None	
widen	[ˈwaɪdn]	vt.& vi.  放宽，加宽，（使）变宽；	
widespread	[ˈwaɪdspred]	adj.  分布广的； 普遍的； 广泛应用； 普及的	
widow	[ˈwɪdəʊ]	n.  寡妇； 遗孀； [牌]放在一边的几张牌； [印]未排足的行	vt.  使成寡妇； 从…夺走； 杀死…的丈夫；	
width	[wɪdθ]	n.  宽度； 广度；	
wisdom	[ˈwɪzdəm]	n.  智慧，明智； 常识，好的判断力； 知识，学问； 古训	
wit	[wɪt]	n.  机智； 才智，智慧； 富有机智的人； 打趣话，玩笑话	
withdraw	[wɪðˈdrɔ:]	vt.  撤走； 拿走； 撤退； （从银行） 取 （钱）	vi.  撤退； （从活动或组织中） 退出；	
withstand	[wɪðˈstænd]	vt.  经受，承受，禁得起； 反抗；	vi.  反抗； 耐得住，禁得起；	
witness	[ˈwɪtnəs]	n.  目击者，见证人； [法]证人； 证据；	vt.  出席或知道； 作记录； 提供或作为…的证据；	vi.  做证人； 见证；	
wolf	[wʊlf]	n.  狼； 贪婪的人； 有害的幼虫；	vt.  狼吞虎咽；	
wool	[wʊl]	n.  羊毛； 羊毛制品； （幼虫的）毛； 羊毛覆盖物	
workman	[ˈwɜ:kmən]	n.  工人； 技工，工匠；	
workshop	[ˈwɜ:kʃɒp]	n.  车间； 专题讨论会，研究会； 创作室； 实习班，实验班	
world-wide	['wɜ:ldw'aɪd]	adv.  遍及全世界地；	adj.  全世界的； 传遍世界的；	
worm	[wɜ:m]	n.  虫，蠕虫； （昆虫的）幼虫； 寄生虫； 懦夫	vt.& vi.  蠕动，曲折行进； 给（动物）驱肠虫； 使缓慢前进；	
worship	[ˈwɜ:ʃɪp]	vt.  崇拜，尊崇； 爱慕；	vi.  做礼拜； 热爱； 爱慕； 崇拜（尤指达到看不到缺点的地步）	n.  （对治安官或市长的尊称）阁下； 尊敬； 崇拜； 礼拜	
worthless	[ˈwɜ:θləs]	adj.  无价值的，不值钱的； 卑微的； 不足取的，不足道的； 不足轻重	
worthwhile	[ˌwɜ:θˈwaɪl]	adj.  值得做的； 值得花时间的； 有价值的； 合算	
worthy	[ˈwɜ:ði]	adj.  应得某事物； 值得做某事； 可尊敬的； 配得上的，相称的	n.  杰出人物，伟人；	
wrap	[ræp]	vt.  包； 缠绕； 用…包裹（或包扎、覆盖等）； 掩护	n.  膝毯，披肩，围巾，围脖，头巾，罩衫，外套，大衣； 包装纸； 〈俚〉机密；	vi.  缠绕，盘绕（通常与 over, around 等连用）； 包上，裹上； 穿上（衣服等）；	
wreck	[rek]	vt.  破坏，毁坏； 拆除； 使遇难；	n.  毁灭，失事； 遇难船的残骸； （身体或精神上）受到严重损伤的人； 状况非常糟糕的车辆（或建筑物等）	vi.  使（船舶）失事，使遇难，使下沉；	
wardrobe	[ˈwɔ:drəʊb]	n.  衣柜，衣橱； 藏衣室； （个人，戏团的）全部服装； 行头	
warfare	[ˈwɔ:feə(r)]	n.  战争，战争状态； 斗争，冲突； 军事行为； 兵火	
alike	[əˈlaɪk]	adj.  同样的，相似的；	adv.  同样地； 两者都，同样地； 类似于；	
alliance	[əˈlaɪəns]	n.  （国家、政党等的）结盟，同盟，联盟，联合； 联姻； 同盟条约； 同盟者	
allocate	[ˈæləkeɪt]	vt.  分配，分派； 把…拨给；	
allow	[əˈlaʊ]	vt.  允许； 承认； 给予； 准许（做某事）	vi.  容许； 考虑；	
allowance	[əˈlaʊəns]	n.  津贴，补贴，零用钱； 限额； 折扣； 默许，默认	vt.  给（某人）零用钱或津贴； 按定量供给；	
ally	[ˈælaɪ]	n.  同盟国，同盟者； 助手，支持者； 协约国； 联盟	vt.&vi.  （使）联盟，（使）同盟； （使）结盟，（使）联姻；	
alongside	[əˌlɒŋˈsaɪd]	adv.  在…的侧面； 在…旁边； 与…并排；	prep.  在…旁边； 横靠； 傍着；	
alphabet	[ˈælfəbet]	n.  字母表； 字母系统； 入门，初步；	
alter	[ˈɔ:ltə(r)]	vt.  改变； 更改； 改建（房屋）； （人）变老	vi.  改变； 修改；	
alternative	[ɔ:lˈtɜ:nətɪv]	adj.  替代的； 备选的； 其他的； 另类的	n.  可供选择的事物；	
altitude	[ˈæltɪtju:d]	n.  高度，海拔高度； 高位，高等； [天]地平纬度； [数]顶垂线	
aluminium	[ˌæljəˈmɪniəm]	n.  铝；	adj.  铝的；	
amateur	[ˈæmətə(r)]	n.  业余爱好者； 外行，生手；	adj.  业余的，非职业的； 外行的；	
amaze	[əˈmeɪz]	vt.  使大为吃惊，使惊奇；	n.  吃惊，好奇；	
ambassador	[æmˈbæsədə(r)]	n.  大使，使节； （派驻联合国等国际组织的）代表； 特使； [比喻]使者	
ambition	[æmˈbɪʃn]	n.  抱负； 渴望得到的东西； 追求的目标； 夙愿	vt.  追求； 有…野心；	
ambulance	[ˈæmbjələns]	n.  救护车； 野战医院；	
amid	[əˈmɪd]	prep.  （表示位置）在…中间； （表示环境）处于…环境中； 由于存在…情况； （表示让步）尽管有…的情况	
amongst	[ə'mʌŋst]	prep.  （表示位置）处在…中； （表示范围）在…之内； （表示牵涉）经过； （表示所属）为…所特有	
amuse	[əˈmju:z]	vt.  使人发笑； 逗乐； 使消遣； 娱乐	
analyse	[ˈænəlaɪz]	vt.  分析； 分解； 细察；	na.  “analyze”的变体；	
analysis	[əˈnæləsɪs]	n.  分析，分解； 梗概，要略； [数]解析； 验定	
ancestor	[ˈænsestə(r)]	n.  祖先，祖宗； 被继承人； 原型； （动物的）原种，先祖	
anchor	[ˈæŋkə(r)]	n.  锚； 靠山； 节目主持人； 固定桩	vt.  抛锚，抛锚泊船； 使固定，使稳固； 使稳定； 在…任节目主持人	vi.  抛锚，停泊； 固定； [体]任主要运动员； 主持节目	
ancient	[ˈeɪnʃənt]	adj.  古代的，已往的； 古老的，过时的； 年老的； 老式的	n.  古代人； 古文明国的国民； 高龄老人； 旗手	
angle	[ˈæŋgl]	n.  角； [比喻]（考虑、问题的）角度； 观点； 轮廓鲜明的突出体	vt.  使形成（或弯成）角度； 把…放置成一角度； 调整（或对准）…的角度； 使（新闻、报道等）带有倾向性	vi.  垂钓； 斜移； 弯曲成一角度； 从（某角度）报道	
ankle	[ˈæŋkl]	n.  踝，踝关节； 脚脖子；	
anniversary	[ˌænɪˈvɜ:səri]	n.  周年纪念日；	adj.  周年的； 周年纪念的； 年年的； 每年的	
annoy	None	None	
annual	[ˈænjuəl]	adj.  每年的； 一年的； [植物]一年生的；	n.  年刊； 一年生植物；	
anticipate	[ænˈtɪsɪpeɪt]	vt.  预感； 预见； 预料； 先于…行动	vi.  过早地提出； 过早地考虑（或说、做）一件事； （在口头或用文字）预言； 预测	
antique	[ænˈti:k]	adj.  古老的，古代的； 过时的，古董的； 古时制造的； 古风的	n.  古玩，古董； 古风，古希腊和古罗马艺术风格；	v.  仿古制作； 使显得古色古香； 寻觅古玩；	
anxiety	None	None	
anxious	[ˈæŋkʃəs]	adj.  焦急的； 渴望的； 令人焦虑的； 流露出忧虑的	
anyhow	[ˈenihaʊ]	adv.  总之； 无论如何； 不管怎样； 随随便便	
anyway	[ˈeniweɪ]	adv.  无论如何； 而且； 尽管； 至少	
apart	[əˈpɑ:t]	adv.  相隔，相距； 分散地，分开地； 成部分，成碎片； 分辨	adj.  分离的，隔离的；	
apartment	[əˈpɑ:tmənt]	n.  寓所，住房； 房间； 公寓楼； （有特殊用途或专属某人的）豪华寓所	
apologize	[əˈpɒlədʒaɪz]	vi.  道歉，认错； 辩解，辩护；	
apology	[əˈpɒlədʒi]	n.  道歉认错，愧悔； 正式辩解，正式辩护； 解释； 〈口〉临时凑合的代用品	
apparent	[əˈpærənt]	adj.  易看见的，可看见的； 显然的，明明白白的； 貌似的，表面的； 显见	
appeal	[əˈpi:l]	n.  上诉； [体育]诉请； 呼吁； （迫切的）要求（帮助、同情等）恳求	vi.  （迫切）要求； 有吸引力； 求助（于）； 提请注意	vt.  将…移交上级法院审理；	
appearance	[əˈpɪərəns]	n.  外貌，外观； 出现，露面； [哲]现象；	
appetite	[ˈæpɪtaɪt]	n.  欲望； 胃口，食欲； 嗜好，爱好；	
applause	[əˈplɔ:z]	n.  热烈鼓掌； 喝彩； 掌声；	
appliance	[əˈplaɪəns]	n.  器具，器械，装置； 家用电器；	
applicable	[əˈplɪkəbl]	adj.  适当的； 可应用的；	
applicant	[ˈæplɪkənt]	n.  申请人，求职人； 请求者；	
application	[ˌæplɪˈkeɪʃn]	n.  适用，应用，运用； 申请，请求，申请表格； 勤勉，用功； 敷用，敷用药	
apply	[əˈplaɪ]	vt.  应用，运用； 申请； 涂； 敷（药）	vi.  申请，请求，适用； 适用，适合； 专心致志；	
appoint	[əˈpɔɪnt]	vt.  任命，委派； 约定，指定； 装设，布置；	
appointment	[əˈpɔɪntmənt]	n.  约定； 任命； 职务； 职位	
appreciate	[əˈpri:ʃieɪt]	vt.  感激； 欣赏； 领会； 鉴别	vi.  （使）增值，涨价；	
approach	[əˈprəʊtʃ]	vt.& vi.  接近，走近，靠近；	vt.  接近； 着手处理； 使移近； 试图贿赂（或影响，疏通）	n.  方法； 途径； 接近；	vi.  靠近；	
appropriate	[əˈprəʊpriət]	adj.  适当的； 恰当的； 合适的；	v.  盗用； 侵吞； 拨（专款等） ；	
approval	[əˈpru:vl]	n.  同意； 批准； 赞成；	
approve	None	None	
approximate	[əˈprɒksɪmət]	adj.  约莫的，大概的； 极相似的； [植]相近但不连接的；	vi.  接近于； 近似于；	vt.  靠近； 使接近； 使结合；	
arbitrary	[ˈɑ:bɪtrəri]	adj.  随意的，任性的，随心所欲的； 主观的，武断的； 霸道的，专制的，专横的，独断独行的； 乱	
architect	[ˈɑ:kɪtekt]	n.  建筑师，设计师； 创造者，缔造者； 造物主；	
architecture	None	None	
argue	[ˈɑ:gju:]	vt.  坚决主张； 提出理由证明； 说服，劝告； 表明，证明	vi.  争论，辩论； 提出理由；	
argument	[ˈɑ:gjumənt]	n.  争论，争吵； 论据； [数]幅角； 主题，情节	
arise	[əˈraɪz]	vi.& vt.  产生； 出现； 起身，起立； 起源于，产生于	
arithmetic	[əˈrɪθmətɪk]	n.  算术，计算； 算法；	
arouse	[əˈraʊz]	vt.  引起； 唤醒； 激起性欲； 使行动起来	
arrange	[əˈreɪndʒ]	v.  安排； 筹备； 整理； 排列 谱写；	
arrangement	[əˈreɪndʒmənt]	n.  安排； 排列； 约定； 改编	
arrest	[əˈrest]	vt.  逮捕，拘捕； 止住，阻止，抑制； 吸引（注意）；	vi.  心跳停止；	n.  拘留； 停止，阻止； 制动（装置）；	
arrival	[əˈraɪvl]	n.  到达，抵达； 出现，登场； 新生婴儿； 到达者	
arrow	[ˈærəʊ]	n.  矢，箭； 箭状物； 箭头记号； [天]天箭座	
artificial	[ˌɑ:tɪˈfɪʃl]	adj.  人造的； 人工的； 虚假的，非原产地的； 人为的	n.  人造肥料； 假花；	
artistic	[ɑ:ˈtɪstɪk]	adj.  艺术的； 有美感的； 风雅的； （尤指）有美术才能的	
ash	[æʃ]	n.  灰，灰烬； 灰色，苍白； 骨灰； 废墟	
ashamed	[əˈʃeɪmd]	adj.  惭愧的，羞耻的，害臊的； 难为情；	
aside	[əˈsaɪd]	adv.  在旁边，在一边，到旁边，到一边； 撇开（…暂且不谈），留存； [戏]独（白），旁（白）； （用于名词后）除…以外	n.  [戏]旁白，独白； 低声说的话，离题话；	prep.  在…旁边；	
aspect	[ˈæspekt]	n.  方面； 面貌； 方位，方向； 形势	
assemble	[əˈsembl]	vt.& vi.  集合，收集；	vt.  装配，组合；	
assembly	[əˈsembli]	n.  立法机构； 议会； 集会； 装配	
assess	[əˈses]	vt.  评定； 估价； 对（财产、收入等）进行估价（作为征税根据）； 确定（损害赔偿金、税款、罚款等）的金额	
asset	[ˈæset]	n.  资产，财产； 有价值的人或物； 有用的东西； 优点	
capture	[ˈkæptʃə(r)]	vt.  俘获； 夺取； 夺得； 引起（注意、想像、兴趣）	n.  捕获； 占领； 捕获物； [计算机]捕捉	
carbon	[ˈkɑ:bən]	n.  [化学]碳； （一张）复写纸； [电]碳精棒[片，粉]，碳精电极； 复写的副本	adj.  碳的； 碳处理的；	
career	[kəˈrɪə(r)]	n.  生涯； 职业； 事业；	vi.  全速前进，猛冲；	
cargo	[ˈkɑ:gəʊ]	n.  （船或飞机装载的）货物； 负荷，荷重；	
carpenter	[ˈkɑ:pəntə(r)]	n.  木工，木匠；	v.  当木匠； 做木工活；	
carpet	[ˈkɑ:pɪt]	n.  地毯，桌毯； 毛毯，绒毯； 地毯状覆盖物； （装在飞机上的）雷达电子干扰仪	vt.  在…上铺地毯； 把地毯铺在…上； 斥责；	
carriage	[ˈkærɪdʒ]	n.  运输，输送； （旧时载客的）四轮马车； 〈英〉火车客车车厢； 运费	
carrier	[ˈkæriə(r)]	n.  搬运人； 运输公司； 搬运器； [医学]带菌者	
carrot	[ˈkærət]	n.  胡萝卜； 〈非正式〉好处，回报； 不能兑现的报酬；	
cart	[kɑ:t]	n.  运货马车，手推车； 一车之量；	vt.  用推车或卡车运送； 费力搬运； 强行带走，抓走；	
cartoon	[kɑ:ˈtu:n]	n.  漫画； 讽刺画； 动画片； 草图	vt.  为…画漫画；	vi.  画漫画；	
cash	[kæʃ]	n.  现金； 支付金额；	vt.  支付现款； 兑现；	adj.  现金的；	
cashier	[kæˈʃɪə(r)]	n.  出纳员；	vt.  解雇； 抛弃；	
cassette	[kəˈset]	n.  盒式录音带； 摄影胶卷暗匣，弹夹； 珠宝箱，宝匣；	
cast	[kɑ:st]	vt.  铸造； 投掷； 投射； 脱落，脱皮	n.  铸型； 演员表； 轻微的斜视； 投，掷骰	vi.  掷，投； 计算，加；	
casual	[ˈkæʒuəl]	adj.  偶然的； 临时的； 随便的； 非正式的	n.  临时工人； [军]待命士兵； 没有固定工作的劳动者； 不定期领取救济金的人 便装；便鞋；临时工；	
catalog	['kætəlɔ:g]	n.  目录，目录册，目录簿； [美]大学概况一览； 登记，记载； 产品样本	vt.  登记； 为…编目； 编目录； 记载	v.  把…按目录分类； 把…编目；	
catalogue	[ˈkætəlɒg]	n.  目录，一览表； （美）大学情况便览； 展览目录； 产品样本	vt.  为…编目录； 登记分类； 记载，列入目录； 登记（某人、某事的）详情	
category	[ˈkætəgəri]	n.  类型，部门，种类，类别，类目； [逻，哲]范畴； 体重等级；	
cattle	[ˈkætl]	n.  （总称）牛，牲口； 畜生； 无价值的人； 〈美俚〉女学生	
cautious	[ˈkɔ:ʃəs]	adj.  小心的，谨慎的； 兢； 恮； 持重	
cease	[si:s]	vt.  停止，终止，结束；	vi.  终止，停止； 永不停止的过程； 停止行动；	n.  停止；	
cement	[sɪˈment]	n.  水泥； 胶合剂； 胶接剂； 粘固粉	vt.  粘牢； 巩固； （用水泥、胶等）粘结； 在…上抹水泥	
center	['sentə]	n.  中心； （球队的） 中锋； 中心区； 中枢	adj.  中央的，位于正中的； （在）中心的；	vt.  集中； 使聚集在一点； 定中心； 居中	vi.  居中，有中心，被置于中心；	
centigrade	[ˈsentɪgreɪd]	adj.  百分度的； 摄氏的； 摄氏温度计的；	n.  摄氏；	
centimetre	[ˈsentɪmi:tə(r)]	n.  厘米，公分； =“centimeter”（美）；	
ceremony	[ˈserəməni]	n.  典礼，仪式； 礼仪，礼节； 虚礼，客气；	
certificate	[səˈtɪfɪkət]	n.  证明书； 文凭，结业证书；	vt.  发给证明书； 用证书证明（或认可）；	
challenge	[ˈtʃæləndʒ]	n.  挑战； 盘问； 质疑； 怀疑	vt.  质疑； 向…挑战；	vi.  提出挑战，要求竞赛（或竞争）； 驳斥；	
chamber	[ˈtʃeɪmbə(r)]	n.  室，卧室，会客室； 内庭； [多用于英国]律师的办公室； 议事厅	vt.  限制，幽禁，封闭或限制； 使备有房间；	
champion	[ˈtʃæmpiən]	n.  冠军； 捍卫者，拥护者； 战士；	vt.  为…而斗争，捍卫，声援；	adj.  优胜的； 第一流的；	
channel	[ˈtʃænl]	n.  频道，波道； 渠道； 途径； 海峡	vt.  引导，开导； 形成河道；	
chaos	[ˈkeɪɒs]	n.  混乱，紊乱； （天地未出现的）浑沌世界； 〈古〉无底深渊； 一团糟	
chap	[tʃæp]	n.  小伙子，小家伙，家伙；	vt.& vi.  （使）疼痛，变粗糙，皲裂；	
chapter	[ˈtʃæptə(r)]	n.  章，回； （俱乐部、协会等的）分会； 人生或历史上的重要时期；	vt.  把…分成章节；	
character	[ˈkærəktə(r)]	n.  性格； 特点； 字母； 角色，人物	vt.  刻，印； 使具有特征；	
characteristic	[ˌkærəktəˈrɪstɪk]	adj.  特有的； 独特的； 表示特性的； 显示…的特征的	n.  特性，特征，特色，[数]（对数的）首数； 独特性； 性质；	
characterize	[ˈkærəktəraɪz]	vt.  描述（人或物）的特性； 具有…的特征；	vi.  塑造人物；	
charge	[tʃɑ:dʒ]	vt.  装载； 控诉； 使充电； 索（价）	vi.  索价； 向前冲； 记在账上； 充电	n.  费用； 指示； 掌管； 指责 电荷；	
charity	[ˈtʃærəti]	n.  慈善（行为）； 施舍，捐助； 慈善机关； 仁爱，宽容	
charm	[tʃɑ:m]	n.  魔力； 魅力； 咒文； （表链等的）小装饰品	vt.  使陶醉； 诱惑； 对…行魔法； 令人陶醉	
chart	[tʃɑ:t]	n.  图表； 航海图； 排行榜；	vt.  绘制地图； 记录； 记述； 跟踪（进展或发展）	
charter	[ˈtʃɑ:tə(r)]	n.  许可证； 纲领； 宪章； 包租	vt.  发给…许可证； 发给特许执照；	
chase	[tʃeɪs]	vt.  追捕； 追求； 追寻； 镂刻	n.  追捕； 打猎； 猎物（指鸟兽等）； 槽	vi.  追逐，追赶； 追寻； 追求（常与after连用）； [口语] 奔跑	
cheat	[tʃi:t]	vt.  欺骗，诈骗； 误导，愚弄； 躲避，逃脱；	vi.  作弊，行骗； 犯规； 俚〉不忠； 消磨，解（闷），消除（疲劳）	n.  欺骗（行为）； 骗子； 雀麦； 〈美俚〉反光镜	
cheerful	[ˈtʃɪəfl]	adj.  欢乐的，高兴的； 令人愉快的；	
chemical	[ˈkemɪkl]	adj.  化学的； 用化学方法制造的，化学作用的；	n.  化学药品，化学制品；	
chemist	[ˈkemɪst]	n.  化学家； 药剂师； 药商； 药房	
chest	[tʃest]	n.  胸部，胸腔； 箱子； 金库； 资金	
chew	[tʃu:]	vt.& vi.  咀嚼，咬； 深思，考虑；	n.  咀嚼； 咀嚼物；	
chief	[tʃi:f]	adj.  级别最高的； 总的； 主要的； 最重要的	n.  族长； 酋长； 首领； 主管人员	
childhood	None	None	
chill	[tʃɪl]	vt.& vi.  （使）变冷； 使很冷； 使冰冷； 使恐惧	n.  寒冷，发冷； 冷漠； 扫兴； [冶金学]激冷	adj.  冷的； 冷漠的； 令人失望的；	vt.  令失望； 使沮丧； 使扫兴； 使消沉	
chin	[tʃɪn]	n.  （尤指人的）颏，下巴； 聊天； 引体向上动作；	v.  用下巴夹住； 聊天； 作引体向上动作；	
chip	[tʃɪp]	n.  碎片； 缺口； （作赌注用的）筹码； （足球）高球	vt.  刻，削成； 凿； 从…上削下一小片；	vi.  剥落； 碎裂；	
choke	[tʃəʊk]	vt.& vi.  阻止，扼止； 填塞； 使窒息； 哽咽	n.  窒息，哽咽； 拥塞； （车辆发动机的）阻风门；	
chop	[tʃɒp]	v.  切碎，砍； 向下猛击； 降低； 终止	n.  砍，剁； 排骨； 掌劈； 嘴周围的地方	
Christ	[kraɪst]	n.  基督； 救世主；	int.  〈俚〉哎呀；	
Christian	[ˈkrɪstʃən]	n.  基督教徒，信徒； 克里斯琴； 人类，文明人，正派人； [电影]克里斯蒂安	adj.  信基督教的，基督教的，基督教徒的； 人（类）的，文明的，正派的，高尚的；	
cigar	[sɪˈgɑ:(r)]	n.  雪茄； 叶卷烟；	
cigarette	[ˌsɪgəˈret]	n.  纸烟，香烟；	
circuit	[ˈsɜ:kɪt]	n.  电路，线路； 巡回； 唤醒，环形道； 〔电〕电流	vt.  巡回，周游；	
circular	[ˈsɜ:kjələ(r)]	adj.  圆形的； 环行的； 迂回的，绕行的； 供传阅的，流通的	n.  通知，通告； 印制的广告，传单；	
circulate	[ˈsɜ:kjəleɪt]	vt.& vi.  （使）循环； （使）流通； （使）流传； 散布	vi.  传送，传递，传阅；	
circumstance	[ˈsɜ:kəmstəns]	n.  环境，境遇； 事实，细节； 典礼，仪式；	vt.  使处于某种特定的情况之下；	
cite	[saɪt]	vt.  引用，引证； [法]传讯； 表扬； [军事]传（或通）令嘉奖	n.  例证，引文；	
civil	[ˈsɪvl]	adj.  公民的，市民的； 文明的，有礼貌的； 民用的，国民间的； [法]民事的，根据民法的	
civilian	[səˈvɪliən]	n.  平民，百姓； 市民； 文官； 民法学者	adj.  民用的； 平民的；	
civilization	[ˌsɪvəlaɪˈzeɪʃn]	n.  文明，文化； 开化，教化； 修养； 文明社会	
civilize	[ˈsɪvəlaɪz]	vt.  使文明； 使开化； 教化； 启发	vi.  变得文明；	
claim	[kleɪm]	vt.  声称； 断言； 需要； 索取	vi.  提出要求；	n.  （根据权利而提出的）要求； 声称； 断言； 索赔	
clap	[klæp]	vt.& vi.  拍手，鼓掌； 轻轻拍打某人； 急速放置； 振翼，拍翅膀	n.  鼓掌，拍手； 拍手声； 噼拍声； 破裂声	vi.  鼓掌，拍手； 啪地关上；	
clarify	[ˈklærəfaɪ]	vt.& vi.  使清楚，澄清；	vt.  （尤指通过加热使黄油）纯净； 说明； 使（头脑、神智等）清醒；	vi.  （液体）变得澄清； 净化； 变得清楚；	
clash	[klæʃ]	vt.  发出撞击声；	vi.  争论； 不合； 交锋； 撞击出刺耳的响声	n.  冲突； 不协调； 撞击声；	
classic	[ˈklæsɪk]	adj.  典型的； 传统式样的； 著名的； 有趣的	n.  文豪； 文学名著； 优秀的典范； 古希腊与古罗马的文化研究（尤指对其语言与文学的研究）	
classical	[ˈklæsɪkl]	adj.  古典的，经典的； 传统的； 古典文学的； 第一流的	n.  古典音乐；	
classification	None	None	
classify	[ˈklæsɪfaɪ]	vt.  分类，归类； 把…列为密件；	
clause	[klɔ:z]	n.  从句，分句； 条款，款项；	
claw	[klɔ:]	n.  （动物的）爪； （蟹等的）钳； 爪形器具；	vt.& vi.  用爪抓（或挖）；	
clay	[kleɪ]	n.  黏土，泥土； （相对于灵魂而言的）人体，肉体； 似黏土的东西； 克莱（男子名， Clayton 的昵称）	vt.  用黏土处理；	
crawl	[krɔ:l]	vi.  爬行； 缓慢行进； 巴结；	n.  缓慢的爬行； 〈美俚〉跳舞，自由式游泳； 养鱼（龟）池；	
create	[kriˈeɪt]	vt.  创造，创作； 产生； 封爵，把…封为（贵族）；	vi.  [英][俚]大发脾气，大发牢骚；	
creative	[kriˈeɪtɪv]	adj.  创造性的，有创造力的； 有创意的，创新的，创造的；	n.  （非正式）创意人士；	
creature	[ˈkri:tʃə(r)]	n.  生物，动物； 人； 创造物； （他人的）工具	
credit	[ˈkredɪt]	n.  信誉，信用； [金融]贷款； 荣誉； 学分	vt.  相信，信任； 归功于； [会]记入贷方； 赞颂	
creep	[kri:p]	vi.  爬行，匍匐； 缓慢地行进；	n.  爬行，蠕动； 虫爬着似的感觉，毛骨悚然； 卑鄙小人，谄媚者；	
crew	[kru:]	n.  全体工作人员； 全体乘务船员，全体船员； 一群，一帮； 专业团队	v.  当（尤指船上的）工作人员；	
crime	[kraɪm]	n.  罪行，犯罪； 罪恶；	v.  指控犯罪； 判定犯罪； 处罚军事犯；	
criminal	[ˈkrɪmɪnl]	n.  罪犯，犯人；	adj.  刑事的； 犯罪的； 可耻的；	
crisis	[ˈkraɪsɪs]	n.  危机； 危难时刻； 决定性时刻，紧要关头； 转折点	
critic	[ˈkrɪtɪk]	n.  批评家； 评论员； 批评者； 挑剔的人	
critical	[ˈkrɪtɪkl]	adj.  批评的，爱挑剔的； 关键的； 严重的； 极重要的	
criticism	[ˈkrɪtɪsɪzəm]	n.  批评，批判； 鉴定，审定，考证，校勘； 苛求，[哲]批判主义； 评论，评论文章	
criticize	[ˈkrɪtɪsaɪz]	vt.& vi.  分析，评估； 批评； 挑剔；	
crossing	[ˈkrɒsɪŋ]	n.  人行横道，十字路口； 交叉，相交； 横越； 渡口	v.  交叉(cross的现在分词)；	
crowd	[kraʊd]	n.  人群； 群众； 一群；	vi.  拥挤，聚集；	vt.  挤满； 将…塞进； 催逼；	
crown	[kraʊn]	n.  王冠； 花冠（有时象征胜利）； 王权； （某物的）顶部	vt.  （尤指通过增添成就、成功等）使圆满； 为…加冕； 使圆满完成； 给…以荣誉	vi.  露顶；	
crucial	[ˈkru:ʃl]	adj.  关键性的，极其显要的； 决定性的； 十字形的；	
crude	[kru:d]	adj.  粗糙的，粗杂的； 粗鲁的； 天然的，未加工的； 简陋的	n.  原[生]材料，天然物质； 原油；	
cruise	[kru:z]	vi.  巡游； 漫游； 巡航；	n.  （军舰等）巡逻，巡航； 〈口〉游览，旅行，周游；	vt.  巡航； 巡游； 漫游；	
crush	[krʌʃ]	vt.  压破，压碎； 镇压； 弄皱； 挤榨，榨出	vi.  挤； 被压碎，被起皱；	n.  粉碎，被压碎的状态； （特指女子对男性的）迷恋； 拥挤的人群； 果汁饮料	
crust	[krʌst]	n.  面包皮； 外壳； 硬外皮； 地壳	vt.  用外皮覆盖； 在…上结硬皮； 生痂儿；	vi.  结成外壳； 结硬皮；	
crystal	[ˈkrɪstl]	n.  结晶（体）； 晶体； 水晶； 水晶饰品	adj.  水晶的； 水晶般的； 透明的； 清楚的	
cube	None	None	
cue	[kju:]	n.  暗示，提示； 线索； [台]球杆； 情绪，心情	vt.  把…插入演出； 给…暗示；	
cultivate	[ˈkʌltɪveɪt]	vt.  耕作，种植； 教养，栽培； 改善； 交朋友	
culture	[ˈkʌltʃə(r)]	n.  文化； [生物学]（微生物等的）培养； 修养； 养殖	vt.  培植，培养；	
cupboard	[ˈkʌbəd]	n.  橱柜； 衣柜； 食物柜； 壁橱	
curiosity	[ˌkjʊəriˈɒsəti]	n.  好奇心，爱打听的癖性； 奇人； 奇物，古玩； 奇特性	
curious	[ˈkjʊəriəs]	adj.  好奇的；  好求知的； 奇妙的；  稀奇的	
curl	[kɜ:l]	n.  一绺鬈发； 卷曲物； 螺旋状物； （指头发）蜷曲	vt.& vi.  （使）弯曲； （使）卷曲； 盘旋； 缠绕	vt.  撅起嘴唇； 撇（嘴）； （使）呈螺旋（或卷曲）状移动； （使）旋绕	
currency	[ˈkʌrənsi]	n.  货币； 通用，流通，流传，传播； 市价，行情； 流通时间	
current	[ˈkʌrənt]	adj.  现在的； 最近的； 流行的； 流传的	n.  趋势； 电流； 水流； 涌流	
curriculum	[kəˈrɪkjələm]	n.  全部课程，课程；	
curse	[kɜ:s]	vt.& vi.  诅咒； 咒骂； 使苦恼，使困苦； 把（某人）逐出教门	n.  诅咒； 咒语； 祸害，祸因； 咒逐，逐出教门	
curtain	[ˈkɜ:tn]	n.  窗帘，门帘； 帐幕之物，幕布； 启幕，落幕；	vt.  给（窗户或房间）装上帘子； 掩蔽；	
curve	[kɜ:v]	n.  弧线，曲线； 曲线状物； 弯曲物； [棒]曲线板	vt.  使弯曲； 使成曲线； 使成弧形；	vi.  弯曲； 弯成曲线，弯成弧形； 沿曲线行进；	adj.  弯曲的； 曲线形的；	
cushion	[ˈkʊʃn]	n.  （隔离两个表面的）垫； 垫子； 起保护（或缓冲）作用的事物； （台球等运动）（台球桌内侧边缘的）弹性衬里	vt.  使免遭损害； 使免受令人不快的影响； （用垫子）使柔和； （跌倒或碰撞时）起缓冲作用	
cycle	[ˈsaɪkl]	n.  循环，周期； 自行车； 时代，一段时间； 整套	vi.  周而复始，循环； 骑自行车； 轮转；	vt.  运转，循环； 使轮转；	
dairy	[ˈdeəri]	n.  牛奶场； 乳品店； 牛奶及乳品业；	adj.  牛奶的； 奶制的； 乳品的； 乳品业的	
dam	[dæm]	n.  水坝，堰； 水库； （牙科用的）橡皮障； 〈比喻〉障碍	vt.  用水坝阻止； 阻塞，抑制；	
damn	[dæm]	adv.  非常； （表示厌烦）该死； 讨厌； 十足	vt.  诅咒； 谴责，指责； 使…失败； [永世受罚，定罪	vi.  诅咒； 咒骂；	n.  一点也不，丝毫；	adj.  该死的； （表示厌烦）可恶的；	
damp	[dæmp]	adj.  微湿的，潮湿的； 消沉的，沮丧的； 沉闷的； 情绪低落的	n.  潮湿； 消沉，失望； 矿井瓦斯； 有毒气体	vt.  使潮湿； 使泄气，使沮丧； 抑制，阻抑； 使减弱	vi.  [物]阻尼； 减幅；	
dash	[dæʃ]	vi.  猛冲； 赶紧离开；	vt.  猛撞； 匆忙完成； 泼溅； 使…破灭	n.  少量，些许； 猛冲； 破折号； 短跑	
data	[ˈdeɪtə]	n.  资料，材料； datum的复数； [计算机]数据，资料； 从科学实验中提取的价值	
daylight	[ˈdeɪlaɪt]	n.  日光，白昼； 清早，黎明； 公开，发表； 眼睛，视力	
deadline	[ˈdedlaɪn]	n.  最后期限； 截止期限； 死线； 原稿截止时间	vt.  通过设定一时间期限来统治；	
deaf	[def]	adj.  聋的； 不愿听的；	
debate	[dɪˈbeɪt]	n.  讨论； 辩论； 争论； 辩论	vt.& vi.  辩论； 仔细考虑； 思考； 盘算	
debt	[det]	n.  债务； 负债情况； 义务； 罪，过失	
decade	[ˈdekeɪd]	n.  十年，十年间； 十个一组； 十年期；	
decay	[dɪˈkeɪ]	vt.& vi.  （使）腐烂，腐朽；	vi.  衰败，衰退，衰落；	n.  腐败、衰退的状态；	
deceive	[dɪˈsi:v]	v.  欺诈； 误导；	
decent	[ˈdi:snt]	adj.  正派的； 得体的； （服装等）相称的，合宜的； 相当好的	
deck	[dek]	n.  甲板，舱板； [建]平屋顶，桥面； [铁路]客车车顶； 〈俚〉地面	vt.  装饰； 给…铺上甲板； 打扮；	
declaration	[ˌdekləˈreɪʃn]	n.  宣言，布告，公告，声明； （纳税品在海关的）申报； [法]（原告的）申诉，（证人的）陈述，口供； [牌]摊牌，叫牌	
decline	[dɪˈklaɪn]	n.  下降； （力量、健康、品格、权力、价值等的）衰退； 下倾； （人、生命等的）衰退期	vt.& vi.  辞谢，谢绝（邀请等）；	vi.  （道路、物体等）下倾； （太阳）落下； （在品格、价值上）降低； 衰落，谢绝	vt.  谢绝，婉拒；	
decorate	[ˈdekəreɪt]	vt.  装饰； 点缀； 粉刷； 授予（某人）勋章	vi.  装饰； 布置；	
decrease	[dɪˈkri:s]	n.  减少，减小； 减少量；	vi.&vt.  减少，减小；	
defeat	[dɪˈfi:t]	vt.  击败，战胜； 挫败； [法]宣告无效，作废；	n.  战胜； 失败； [法]废除；	
defect	[ˈdi:fekt]	n.  瑕疵，毛病； 欠缺，缺点；	vi.  叛逃； 背叛；	
define	[dɪˈfaɪn]	vt.  规定； 使明确； 精确地解释； 画出…的线条	vi.  （给词、短语等）下定义，构成释义；	
definite	[ˈdefɪnət]	adj.  明确的； 一定的； 肯定； 有把握	
definitely	[ˈdefɪnətli]	adv.  明确地； 确切地； 一定地； 肯定地	int.  （表强烈的肯定）当然；	
definition	[ˌdefɪˈnɪʃn]	n.  定义； 规定，明确； [物]清晰度； 解释	
delegate	[ˈdelɪgət]	n.  代表，代表团成员；	vt.  委派代表； 授权给； [法律]债务转移；	
delete	[dɪˈli:t]	vt.& vi.  删除；	
deliberate	[dɪˈlɪbərət]	adj.  故意的； 蓄意的； 深思熟虑的； 慎重的	vt.  权衡；	vi.  熟虑； 商讨；	
delicate	[ˈdelɪkət]	adj.  微妙的； 熟练的； 纤弱的； 易损的	
delicious	[dɪˈlɪʃəs]	adj.  美味的，可口的； 有趣的； ； 喷香	
delivery	[dɪˈlɪvəri]	n.  传送，投递； [法]（正式）交付； 分娩； 讲演	
demand	[dɪˈmɑ:nd]	vt.  要求，请求； 需要； [法]召唤； 询问，盘问	n.  需求； 需要； 要求，请求； 销路	vi.  需要； 请求； 查问；	
democracy	[dɪˈmɒkrəsi]	n.  民众； 民主国家； 民主主义； 民主政治	
democratic	[ˌdeməˈkrætɪk]	adj.  民主的； 民主政体的； 民主主义的； 民主党的	
demonstrate	[ˈdemənstreɪt]	vt.  证明，证实； 论证； 显示，展示； 演示，说明	vi.  示威游行；	
dense	[dens]	adj.  密集的，稠密的； 浓密的，浓厚的； 愚钝的；	
density	[ˈdensəti]	n.  密度； 稠密，浓厚； [物]浓度，比重； 愚钝	
dental	[ˈdentl]	adj.  牙齿的； 牙科的； （辅音）齿音的；	n.  齿音；	
deny	[dɪˈnaɪ]	vt.  拒绝； 拒绝承认； 拒绝…占有； 否认知情	
depart	[dɪˈpɑ:t]	v.  离开，出发； 去世； 离职； 脱轨	
departure	[dɪˈpɑ:tʃə(r)]	n.  离开，离去； 起程； 背离； 东西距离	
engine	[ˈendʒɪn]	n.  发动机，引擎； 工具； 火车头； 机车	vt.  给…安装发动机；	
engineering	[ˌendʒɪˈnɪərɪŋ]	n.  工程（学）， 工程师行业； 操纵，管理； 土木工程，工事； 开车技术	
enhance	[ɪnˈhɑ:ns]	vt.  提高，增加； 加强；	
enlarge	None	None	
enormous	[ɪˈnɔ:məs]	adj.  巨大的； 庞大的； 极恶的； 凶暴的	
enquire	[ɪnˈkwaɪə(r)]	vi.  打听；  询问； 问问题； 查问	
enquiry	[ɪn'kwaɪərɪ]	n.  询问； 调查； 查询； 问讯处	
ensure	[ɪn'ʃʊə(r)]	vt.  确保； 担保获得[避免]； 使（某人）获得； 使安全	
entertain	[ˌentəˈteɪn]	vt.  热情款待； 使有兴趣； 娱乐； 抱着，怀有	vi.  热情款待； 娱乐；	
entertainment	[ˌentəˈteɪnmənt]	n.  娱乐，消遣； 招待，款待； 娱乐节目；	
enthusiasm	None	None	
entire	[ɪnˈtaɪə(r)]	adj.  全部的； 整个的； 全体的； 囫囵	
entitle	[ɪnˈtaɪtl]	vt.  使有资格； 给…定名； 给…权力； 称作	
entry	[ˈentri]	n.  进入，入场； 入口处，门口； 登记，记录； 参加比赛的人	
environment	[ɪnˈvaɪrənmənt]	n.  环境，外界； 周围，围绕； 工作平台； （运行）环境	
envy	[ˈenvi]	n.  嫉妒，妒忌； 羡慕；	vi.  感到妒忌； 显示出妒忌；	vt. .  嫉妒，妒忌； 羡慕；	
episode	[ˈepɪsəʊd]	n.  插曲； 片段； 一集； 一段经历	
equality	[iˈkwɒləti]	n.  同等，平等； [数]相等，等式；	
equation	[ɪˈkweɪʒn]	n.  方程式； 等式； 相等； [化学] 反应式	
equip	[ɪˈkwɪp]	vt.  装备，配备； 使具备，使有准备；	
equivalent	[ɪˈkwɪvələnt]	adj.  相等的，相当的，等效的； 等价的，等积的； [化学]当量的；	n.  对等物； [化学]当量；	
era	[ˈɪərə]	n.  纪元，年代； 历史时期，时代； 重大事件；	
erect	[ɪˈrekt]	vt.  使直立，使竖起； 建立，创立； 安装； [医]使勃起	adj.  直立的，垂直的； （头、手等）朝上举的； 直竖的； [医]勃起的	
error	[ˈerə(r)]	n.  错误，过失； [法]误审，违法； [数]误差；	
essay	[ˈeseɪ]	n.  散文； 随笔，杂记文； 尝试，企图； 试验	vt.  尝试； 试验；	
essential	[ɪˈsenʃl]	adj.  基本的； 必要的； 本质的；	n.  必需品； 基本要素； 必不可少的东西；	
establish	[ɪˈstæblɪʃ]	vt.  建立，创建； 确立； 得到认可； 确定	
establishment	[ɪˈstæblɪʃmənt]	n.  企业； 建立； （通常反对变革的）当权派； 反对改革的保守当权派	
estate	[ɪˈsteɪt]	n.  财产，遗产，房地产； 个人财产； 不动产权； （较高的）社会地位	adj.  （汽车）连箱的（拥有较长的车身和后门，后座后面有较大的空间）；	
estimate	[ˈestɪmət]	n.  估计，预测； 报价，预算书； 评价，判断；	vt.  估计，估算； 评价，评论； 估量，估价；	
evaluate	[ɪˈvæljueɪt]	vt.  评价； 求…的值（或数）； 对…评价； [数学、逻辑学]求…的数值	vi.  评价，估价；	
eve	[i:v]	n.  前夕，前夜； 重要事件的前夕； 傍晚；	
event	[ɪˈvent]	n.  事件，大事； 活动，经历； 结果； 运动项目	
evidence	[ˈevɪdəns]	n.  证词； 证据； 迹象； 明显	vt.  使明显； 显示； 表明； 证实	
evident	[ˈevɪdənt]	adj.  明显的，明白的； 昭著； 彰；	
evidently	[ˈevɪdəntli]	adv.  明显地，显而易见； 明显地，清楚地； 错不了，毫无疑问；	
evil	[ˈi:vl]	adj.  邪恶的，罪恶的； 有害的； 不幸的，不吉的； 品行坏的	n.  邪恶，罪恶； 坏事，恶行； 邪恶的力量、势力或化身； 灾祸	
evolution	[ˌi:vəˈlu:ʃn]	n.  演变； 进化； 发展；	
evolve	[iˈvɒlv]	vt.  使发展； 使进化； 设计，制订出； 发出，散发	vi.  发展； [生]通过进化进程发展或发生；	
exact	[ɪgˈzækt]	adj.  准确的； 严密的； 精密的，精确的；	vt.  要求； 苛求； 迫使； 强求	
exaggerate	[ɪgˈzædʒəreɪt]	vt.&vi.  （使）扩大； （使）增加； 夸张；	
exceed	[ɪkˈsi:d]	vt.  超过； 超越； 胜过； 越过…的界限	vi.  突出，领先；	
exceedingly	[ɪkˈsi:dɪŋli]	adv.  非常，极其，特别，十分； 极大地； 过分地； 极度地，极端	
exception	[ɪkˈsepʃn]	n.  例外，一般情况以外的人（或事物），除外； 反对，批评； [法律]异议，反对；	
excess	[ɪkˈses]	n.  超过； 超额量； 多余量； 放肆	adj.  超重的，过量的，额外的；	
excessive	[ɪkˈsesɪv]	adj.  过度的，极度的； 过分的； 过多的； 过逾	
exchange	[ɪksˈtʃeɪndʒ]	n.  交换； 交易； 交易所； 兑换（率）	vt.  交换，互换； 兑换； 交换，调换；	vi.  交换，替换； 进行易货贸易，作物物交换； [金融业]（货币）交换，兑换；	
excitement	[ɪkˈsaɪtmənt]	n.  兴奋，激动； 令人兴奋的事； 刺激，振奋；	
exclaim	[ɪkˈskleɪm]	vt.& vi.  呼喊； 惊叫； 大声说；	
exclude	[ɪkˈsklu:d]	vt.  排除，不包括； 排斥； 驱除，赶出；	
exclusive	[ɪkˈsklu:sɪv]	adj.  专用的； 高级的； 排外的； 单独的	n.  独家新闻； 专有物； 独家经营的产品（或项目、设计等）； 排外者	
excursion	[ɪkˈskɜ:ʃn]	n.  （尤指集体）远足； 短途旅行，游览； 离题； [机]冲程	
execute	[ˈeksɪkju:t]	vt.  执行； 处死，处决； 履行； 完成	
executive	[ɪgˈzekjətɪv]	n.  总经理； 行政部门； [计算机]执行指令；	adj.  执行的； 管理的； 政府部门的；	
exert	[ɪgˈzɜ:t]	vt.  发挥； 运用； 使受（影响等）； 用（力）	
exhaust	[ɪgˈzɔ:st]	vt.  用尽，耗尽； 使精疲力尽； 排出； 彻底探讨	vi.  排气；	n.  （排出的）废气； 排出； 排气装置；	
exhibit	[ɪgˈzɪbɪt]	vt.  陈列，展览； 呈现； 证明； [法]提交证据	vi.  公开展览某物； 展出；	n.  展览，陈列； 展览品； 公开展示； [法]证据	
existence	None	None	
expand	[ɪkˈspænd]	vt.  使…变大； 扩张； 详述；	vi.  扩展； 发展； 张开； 展开	
expansion	[ɪkˈspænʃn]	n.  扩大； 扩张； 扩张物； 膨胀物	
expectation	[ˌekspekˈteɪʃn]	n.  期待； 预期； 前程； [数]期望值	
expense	[ɪkˈspens]	n.  费用； 花费的钱； 消耗； 花钱的东西	vt.  向…收取费用； 把…作为开支勾销；	
experimental	[ɪkˌsperɪˈmentl]	adj.  实验的； 根据实验的； 试验性的；	n.  试验性的东西；	
expert	[ˈekspɜ:t]	n.  专家，能手； 权威； 行家，高手； 熟练者	adj.  专家的； （技术）熟练的； 老手； 需要专门知识（或技术）的	vt.  以专家身份研究（或检查），像专家那样研究（或检查）； 由专家审读（书籍等）；	vi.  做专家工作，担任专家，成为高手（或能手）；	
explode	[ɪkˈspləʊd]	vi.  爆[突]发，发怒； 激增，迅速扩大；	vt.  （使）爆炸； 突然（发出巨响，活跃起来，迸发感情）； 推翻； 驳倒	
exploit	[ɪkˈsplɔɪt]	vt.  开采； 开拓； 利用（…为自己谋利）； 剥削	n.  功绩； 功劳； 勋绩；	
explore	[ɪkˈsplɔ:(r)]	vi.  勘查， 探测， 勘探； [医]探查（伤处等），探索，研究；	vt.  探索， 探究， 仔细查看；	
explosion	[ɪkˈspləʊʒn]	n.  爆炸，炸裂； 爆发； 扩张，激增； （感情，尤指愤怒的）突然爆发	
explosive	[ɪkˈspləʊsɪv]	adj.  爆炸的； 易爆炸的； 突增的； 暴躁的	n.  爆炸物，炸药； [语言学] 爆破音；	
export	[ˈekspɔ:t]	vt.& vi.  出口，输出；	vt.  传播，输出（思想或活动）；	
expose	[ɪk'spəʊz]	v.  使显露； 揭露； 使暴露于；  使体验 （观念、情感）	
exposure	[ɪkˈspəʊʒə(r)]	n.  暴露； 揭发； 公开； （商品等的）展出	
expression	[ɪkˈspreʃn]	n.  表现，表示，表达； 表情，脸色，态度，腔调，声调； [数]式，符号； 词句，语句，措辞，说法	
extend	[ɪkˈstend]	vt.& vi.  延伸； 扩大； 推广；	vt.  伸展； 给予； 延长； 发出（邀请、欢迎等）	vi.  伸出； 延伸； 增加；	
extension	[ɪkˈstenʃn]	n.  伸展，扩大； 延长，延期； [医]牵引； 电话分机	
extensive	[ɪkˈstensɪv]	adj.  广阔的，广大的； 范围广泛的； [物]广延的； [逻]外延的	
extent	[ɪkˈstent]	n.  程度； 长度； 广大地域； 扣押	
exterior	[ɪkˈstɪəriə(r)]	n.  外部，外面，表面，外形，外观； 外貌； [影视]外景，[戏，影视]户外布景；	adj.  外面的，外部的，外表上的，表面的；	
external	[ɪkˈstɜ:nl]	adj.  外面的，外部的； 表面上的； 外用的； 外国的	n.  外部，外面； 外观； 外部情况；	
extra	[ˈekstrə]	adj.  额外的，补充的，附加的； 特大的，特别的；	n.  附加物，额外的事物； 临时演员； 号外； 上等产品，上品	adv.  额外地； 格外地，特别地；	
extraordinary	[ɪkˈstrɔ:dnri]	adj.  非凡的； 特别的； 非常奇特的；	
grand	[grænd]	adj.  宏大的，宏伟的； （最）重要的； 豪华的；	n.  一千美元； 大钢琴；	
grant	[grɑ:nt]	vt.  承认； 同意； 准许； 授予	n.  拨款； 补助金； 授给物（如财产、授地、专有权、补助、拨款等）；	vi.  同意；	
grape	[greɪp]	n.  葡萄； 深紫色，葡萄紫；	
graph	None	None	
grasp	[grɑ:sp]	vt.  抓住； 了解； 急忙抓住； 急切（或贪婪）地抓住	n.  控制； 控制力； 能力所及；	vi.  攫取（常与 at 连用）； 急于接受； 急切地寻求（常与 for 连用）；	
grateful	[ˈgreɪtfl]	adj.  感激的，感谢的； 令人愉快的； 宜人的； 荷	
gratitude	[ˈgrætɪtju:d]	n.  感激，感谢； 感激的样子； 谢意； 恩义	
grave	[ɡreɪv]	adj.  重大的，重要的； 严重的； [音乐]沉重的； （颜色等）朴素的	adv.  沉重地，庄重地； 极慢地；	n.  坟墓，墓穴； 埋葬…的地方； 下场； 死亡	vt.  雕刻； 铭记；	
gravity	[ˈgrævəti]	n.  重力； 万有引力，地心引力； 重要性，严重性； 严肃，庄重	
greedy	[ˈgri:di]	adj.  贪吃的； 贪心的； 贪婪的； 渴望的	
greenhouse	[ˈgri:nhaʊs]	n.  温室，花房； [军]周围有玻璃的座舱，轰炸员舱；	
grind	None	None	
grip	[grɪp]	n.  紧握，抓牢； 握力； 掌握，理解； 能力，胜任	vt.  握紧，抓牢； 吸引住：吸引…的兴趣或注意力； 引起；	vi.  抓牢，紧握：保持紧握；	
grocer	[ˈgrəʊsə(r)]	n.  食品商； 杂货商；	
gross	[grəʊs]	adj.  总的，毛的； 严重的； 令人不快的； 粗鲁的	n.  总收入； 罗（一罗为144个）；	vt.  总共收入为； 总共赚得；	adv.  总共； 全部；	
growth	None	None	
guarantee	[ˌgærənˈti:]	n.  保证，担保； 保证人，保证书； 抵押品；	vt.  保证，担保；	
guidance	[ˈgaɪdns]	n.  指导，引导； 导航； 领导；	
guideline	[ˈgaɪdlaɪn]	n.  指导方针； 指导原则；	
guilty	None	None	
guitar	[gɪˈtɑ:(r)]	n.  吉他； 六弦琴；	vi.  弹吉他；	
gulf	[gʌlf]	n.  海湾； 分歧； 波斯湾； （地面的）裂口	vt.  吞没； 卷进；	
gum	[gʌm]	n.  口香糖； 树胶； 黏胶； 牙龈	vt.& vi.  胶合； 涂以树胶； 使…有粘性；	
guy	[gaɪ]	n.  家伙，伙计； （架设天线、支撑帐篷等用的）牵索； [复数]各位； 一群男人（或女人）	vt.  （用牵索等）牵拉； （用拉索等）固定； 开…的玩笑； 取笑	vi.  [俚语]逃亡，逃走； 乱演某角色；	
gym	[dʒɪm]	n.  健身房； 体育馆； 室内健身操； 体操	
gymnasium	[dʒɪmˈneɪziəm]	n.  健身房，体育馆； 大学预科，高级中学；	
halt	[hɔ:lt]	n.  停止，中止； 暂停； 小火车站；	vt.  使停止； 使中断； 阻止； 使立定	vi.  停止，立定； 犹豫；	
hammer	[ˈhæmə(r)]	n.  铁锤，榔头； 链球； （拍卖时用的）木槌； 音槌	vt.& vi.  锤打； 反复敲打，连续击打（尤指发出大声）；	vt.  击败； 猛踢； 猛击； 轻易打败（对方）	
handbag	[ˈhændbæg]	n.  （女用）手提包； 旅行包；	
handful	[ˈhændfʊl]	n.  少数，少量； 一把（的量）； 难以控制的人（或动物）； 棘手事	
handle	[ˈhændl]	n.  （织物、毛皮等的）手感； 手柄； 举动； 柄状物	vi.  操作，操控； 容易搬运；	vt.  用双手触摸、举起或握住； 用手操作，操纵； 处理或负责，管理； 〈美〉买卖，经营	
handwriting	[ˈhændraɪtɪŋ]	n.  书法，手书； 笔迹，字迹；	v.  亲手写(handwrite的ing形式)；	
handy	[ˈhændi]	adj.  方便的； 手边的，附近的； 便于使用的； 手巧的	
happen	[ˈhæpən]	vi.  发生； 碰巧； 出现； 偶然遇到	
harbour	['hɑ:bə(r)]	n.  海港，港口； 港湾； 避难所； 藏身处	vt.&vi.  隐匿； 怀着； 包含，聚藏； 藏有	na.  “harbor“的变体；	
harden	[ˈhɑ:dn]	vt.  使硬化； 使经得起考验； 使无情； 使轮廓鲜明	vi.  变硬或更硬； 变稳定； 变习惯；	
hardship	[ˈhɑ:dʃɪp]	n.  艰难； 困苦； 艰难情况； 造成困苦与苦难的原因	
hardware	[ˈhɑ:dweə(r)]	n.  五金器具； 计算机硬件； 武器装备；	
harm	[hɑ:m]	n.  损害； 伤害； 危害；	vt.  伤害； 损害； 危害；	
harmony	[ˈhɑ:məni]	n.  协调； 融洽，一致； 和谐； [音]和声	
harness	[ˈhɑ:nɪs]	n.  马具，挽具； 背带； 系带；	vt.  利用； 给（马等）套轭具； 控制；	
harsh	[hɑ:ʃ]	adj.  粗糙的； 刺耳的； 严厉的，严格的； 残酷的	
haste	[heɪst]	n.  匆忙，急忙； 急速，紧迫； 轻率；	v.  赶紧，匆忙； 使快，催促；	
hatred	[ˈheɪtrɪd]	n.  仇恨，憎恶； 敌意；	
hay	[heɪ]	n.  干草； 少量的钱； 一种乡村舞蹈； 成果，酬报	vt.  把（草）制成干草； 用干草喂；	vi.  割草晒干；	
hazard	[ˈhæzəd]	vt.  冒险； 使遭受危险；	n.  危险； 冒险的事； 机会； 双骰子游戏	
heading	[ˈhedɪŋ]	n.  标题，题名； 信头； [航]航向； 斩首	v.  用头顶(head的现在分词)；	
headline	[ˈhedlaɪn]	n.  大字标题； 新闻提要； 头条新闻；	vt.  给…加标题； 担任主角；	
headquarters	[ˌhedˈkwɔ:təz]	n.  （机构，企业等的）总部； 总店； 司令部； 指挥部	
heal	[hi:l]	vt.  恢复健康的状态； 使恢复正常； 使（某人）精神恢复健康；	vi.  变得完整和健全；	
heap	[hi:p]	n.  堆，堆积； 许多，大量； 破车；	vt.  扔成一堆； 完全填满，灌满； 大量或奢侈的赠予；	
hearing	[ˈhɪərɪŋ]	n.  听力，听觉； 审问； 听力所及的距离，听得见的范围； 听证会，〈美〉意见听取会	v.  听到，听见( hear的现在分词)；	
heave	[hi:v]	vt.  举起； 投掷； 使起伏； 呕吐	vt.& vi.  喘息； 呕吐；	vi.  起伏； （山丘等）隆起； 拖； 气喘	n.  举起； 波动； 隆起； 呕吐	
hedge	[hedʒ]	n.  树篱； 保护手段； 防止损失（尤指金钱）的手段；	vt.  用树篱围起； 受…的束缚；	vt.& vi.  回避，避免；	adj.  树篱下的，树篱旁的； 偷偷摸摸的，名声不好的，低劣的；	
heel	[hi:l]	n.  脚后跟，踵； （鞋、袜等的后跟）； （四足动物的）后脚； 踵状物	vt.& vi.  （使）倾斜；	vt.  给（鞋等）修理后跟；	
helicopter	[ˈhelɪkɒptə(r)]	n.  直升机，直升飞机；	vt.  用直升飞机载送；	vi.  乘直升飞机；	
hell	[hel]	n.  地狱，阴间； 训斥； 胡闹，见鬼； 苦境，罪恶之地	vi.  过放荡生活； （车辆）急驰，飞驰；	int.  该死； 见鬼（表示惊奇、烦恼、厌恶、恼怒、失望等）；	
helpful	[ˈhelpfl]	adj.  给予帮助的，有益的； 愿意帮忙的；	
helpless	[ˈhelpləs]	adj.  无助的； 无能的； 无用的； 六亲无靠	
hen	[hen]	n.  母鸡； 雌禽；	
hence	[hens]	adv.  因此，所以； 从此； 从此处；	int.  去；	
herd	[hɜ:d]	n.  兽群； 牧群； 放牧人； 群众，民众	vt.& vi.  群集，纠结；	vt.  放牧； （使）向…移动； 使成群；	
heroic	[həˈrəʊɪk]	adj.  有英雄气概的，英雄的，英勇的； 记叙英雄及其事迹的； 夸张的；	n.  英雄诗，史诗； 英勇行为； 夸张的言行； 咬文嚼字，文诌诌	
hesitate	[ˈhezɪteɪt]	vi.  犹豫，踌躇； 不愿； 支吾； 停顿	vt.  对…犹豫； 不情愿；	
highlight	[ˈhaɪlaɪt]	n.  （图画或照片的）强光部份； 最重要的事情； 最精彩的部分；	vt.  强调，突出； 把…照亮； 标示记号； 为…中最突出的事物	
highly	[ˈhaɪli]	adv.  高度地； 极，非常； 非常赞许地；	
highway	[ˈhaɪweɪ]	n.  公路； 公用通道； 干线； 途径，方法	
hint	[hɪnt]	n.  线索，迹象； 提示，注意事项； 暗示； 微量	vt.  暗示；	vi.  暗示，提示；	
hip	[hɪp]	n.  臀部； [建筑学]屋脊； 臀围（尺寸）； 臀部…的	adj.  （衣服、音乐等方面）时髦的，赶时髦的；	vt.  使…的髋关节脱臼，损伤…的髋部； [建筑学]给（房屋）建屋脊； 使知晓，使了解，告诉； 使消息灵通	
hire	None	None	
historic	[hɪˈstɒrɪk]	adj.  在历史上重要的，有历史影响的； 历史的，历史上的；	
historical	[hɪˈstɒrɪkl]	adj.  历史的，历史上的； 有关历史研究的； 有根据的； 基于史实的	
hobby	[ˈhɒbi]	n.  业余爱好； 嗜好，兴趣； 小马；	
hollow	[ˈhɒləʊ]	adj.  空的； 空洞的； 虚伪的； 空腹的	n.  洞，坑； 山谷；	vt.& vi.  挖空（某物），变空； 挖出（孔、洞）；	adv.  完全，彻底；	
holy	[ˈhəʊli]	adj.  神圣的； 值得尊敬的，值得推崇的； 圣洁的，圣徒般的； 宗教的	
honey	[ˈhʌni]	n.  蜂蜜； 宝贝； 可爱的人；	adj.  蜜的； 心爱的； 加了蜜的； （蜜一样）甘美的	vt.  给…加蜜； 对…甜言蜜语；	
honourable	[ˈɒnərəbl]	adj.  诚实的，正直的； 光荣的，荣耀的； 尊敬的； 高尚的	
hook	[hʊk]	n.  钩，挂钩； 钓钩，鱼钩； 钩拳； 曲线球	v.  钩住； 钓鱼； 打曲线球； 使参与 吸引；	
hopeful	[ˈhəʊpfl]	adj.  抱有希望的； 给人以希望的；	n.  有成功希望的人；	
hopeless	[ˈhəʊpləs]	adj.  不抱希望的，绝望的； 没有希望的，惨淡的； 不可救药的； 不可能的	
horizon	[həˈraɪzn]	n.  地平线； 范围； 界限； 眼界	
kettle	[ˈketl]	n.  （烧水用的）壶； 小汽锅；	
keyboard	[ˈki:bɔ:d]	n.  键盘； 琴键； 电子琴；	vt.  用键盘输入； 用键盘式排字机排字；	vi.  用键盘进行操作； 作键盘式排字机排字；	
kid	[kɪd]	n.  小孩； 小山羊，小山羊皮制品；	vt.& vi.  欺骗，戏弄，取笑；	adj.  较年幼的； 小山羊皮制的；	
kindergarten	[ˈkɪndəgɑ:tn]	n.  幼儿园，学前班；	
kindness	[ˈkaɪndnəs]	n.  仁慈，善行； 友好的行为；	
kingdom	[ˈkɪŋdəm]	n.  王国； 界； 领域；	
kneel	None	None	
knot	[nɒt]	n.  结，绳结，结节，（装饰用的）花结，蝴蝶结； [航]节(=浬/小时)，浬，海里； （树木或木材上的）节疤，（人或动物身上的）硬块，节，瘤； 难事，难题，麻烦事，（问题的）要点，（戏剧，小说的）情节的征结	vt.& vi.  把…打结，把…连结，捆扎，包扎； 使密切结合； 使纠结； 皱（眉）	
label	[ˈleɪbl]	n.  标签； 称标记，符号； [建] 门或窗户上面的线脚；	vt.  贴标签于； 把…称为； 把…列为； [化]用放射性元素使（元素或原子等）示踪	
laboratory	[ləˈbɒrətri]	n.  实验室； 实验课； 研究室； 药厂	
lad	[læd]	n.  少年，小伙子； 〈口〉伙伴，老朋友； 〈英〉管赛马房的马夫； 〈俚〉情人	
lag	[læg]	vi.  走得极慢，落后；	vt.  落后于； 给…加上外套； 把…关进牢里； 逮捕	n.  滞后，（两事件之间的）时间间隔； 囚犯； 防护套； 桶板	
lamb	[læm]	n.  羔羊，小羊； 羔羊肉； 耶稣；	vi.  生小羊，产羊羔；	
landlord	None	None	
landscape	[ˈlændskeɪp]	n.  风景； 风景画； 乡村风景画； 地形	vt.  对…做景观美化，给…做园林美化； 从事庭园设计；	vi.  美化（环境等），使景色宜人； 做庭园设计师；	
lane	[leɪn]	n.  小路，小巷； 航道，空中走廊，规定的单向行车道； 车道； [篮球]罚球区	
lap	[læp]	vt.  折叠； 包裹，缠绕； 使搭接； 磨亮，磨平	vi.  折叠； 部分重叠； 舔； 包围	n.  膝； 下摆； 一圈跑道； 范围	
largely	[ˈlɑ:dʒli]	adv.  大部分地，主要地； 大规模地； 丰富地；	
laser	[ˈleɪzə(r)]	n.  激光； 激光器，镭射器；	
latter	[ˈlætə(r)]	adj.  后者的； 末了的； 较后的；	
laughter	[ˈlɑ:ftə(r)]	n.  笑，笑声； 〈古〉好笑的事； 〈美俚〉力量悬殊得可笑的体育比赛； 大笑	
launch	[lɔ:ntʃ]	vt.  发射； [计算机]开始（应用程序）； 发动； 开展（活动、计划等）	vi.  投入； 着手进行； 热衷于…；	n.  投掷； 大船上的小艇； 大型敞篷摩托艇；	
laundry	[ˈlɔ:ndri]	n.  洗衣店，洗衣房； 洗好的衣服； 待洗的衣服； 洗熨	
lavatory	[ˈlævətri]	n.  厕所； 盥洗室； 洗礼盆；	
lawn	[lɔ:n]	n.  草地，草坪； 上等细麻布；	
layer	[ˈleɪə(r)]	n.  层，层次； 膜； [植]压条； 放置者，计划者	vt.  把…分层堆放； 借助压条法； 生根繁殖； 将（头发）剪成不同层次	vi.  形成或分成层次； [植]通过压条法而生根；	
layout	[ˈleɪaʊt]	n.  布局，安排，设计； 布置图，规划图；	
leader	[ˈli:də(r)]	n.  领袖，领导者； 负责人； 指挥者； 领唱者	
leadership	[ˈli:dəʃɪp]	n.  领导； 领导的才能或能力； 一群领导者； 带路，指引	
leading	[ˈli:dɪŋ]	adj.  重要的，主要的； 前列的； 首位的；	n.  行距； 铅框；	v.  领导（lead的ing形式）；	
leak	[li:k]	vi.  漏出； 透露； （指消息，秘密等）泄密； 漏电，漏水	vt.  使泄露；  擅自公开；	n.  泄漏，漏洞； 裂缝； 漏出物； （俚语）撒尿	
lean	[li:n]	vt.& vi.  （使）倾斜，屈身；	vt.  倚； 依赖； 使斜靠； 使变瘦	adj.  瘦的； 贫瘠的； 简洁的； 精干的	n.  瘦肉； 倾向； 倾斜； 倾斜度	vi.  倾向于（某种观点、意见或态度等）（与to 或 toward连用）；	
leap	[li:p]	vi.  跳； 冲动的行动；	vt.  跳过，跃过； 使跳跃；	n.  跳跃，飞跃； 跳跃的距离；	
learned	[ˈlɜ:nɪd]	adj.  有学问的； 博学的； 学术上的； 精通某门学问的	v.  学习(learn的过去式和过去分词)； 得知；	
learning	[ˈlɜ:nɪŋ]	n.  学问，学术，知识；	v.  学习(learn的现在分词)；	
lease	[li:s]	n.  租约； 租契； 租赁物； 租赁权	vt.  出租； 租借；	
leather	[ˈleðə(r)]	n.  皮，皮革； 皮革制品；	vt.  用皮革包盖； （口）（用皮带等）抽打； 制成皮，蒙上皮；	adj.  皮的，皮革的，皮革制的；	
legal	[ˈli:gl]	adj.  法律的； 合法的； 法定的； 法律（上）的	n.  法定权利； 依法必须登报的声明；	
legislation	[ˌledʒɪsˈleɪʃn]	n.  立法，制定法律； 法律，法规；	
leisure	[ˈleʒə(r)]	n.  空闲时间； 闲暇； 悠闲； 安逸	adj.  空闲的； 闲暇的；	
lemon	[ˈlemən]	n.  柠檬； 柠檬树； 柠檬黄；	adj.  柠檬色的；	
lens	[lenz]	n.  透镜，镜头； 眼睛中的水晶体； 隐形眼镜； 汽车的灯玻璃	
lest	[lest]	conj.  唯恐； 以免； 惟恐； 生怕	
liable	[ˈlaɪəbl]	adj.  有责任的； 有义务的； 有…倾向的； 易…的	
liberal	[ˈlɪbərəl]	n.  自由主义者； 自由党党员；	adj.  开明的； 自由的； 慷慨的； 不拘泥的	
liberate	[ˈlɪbəreɪt]	vt.  解放； 释放； 释出，放出；	
liberty	[ˈlɪbəti]	n.  自由； 许可权； 放肆，无礼； 解放，释放	
librarian	[laɪˈbreəriən]	n.  图书管理员； [计算机]库管理程序；	
license	[ˈlaɪsns]	n.  许可证，执照； 特许；	vt.  同意； 发许可证；	
lick	[lɪk]	vt.  舔； 打败；	vt.& vi.  轻轻拍打； 战胜；	n.  舔； 一舐的量，少量；	
lid	[lɪd]	n.  盖子； 限制； [口]果盖； [口]遮盖	vt.  给…盖盖子；	
lightning	[ˈlaɪtnɪŋ]	adj.  闪电般的，快速的；	n.  闪电，雷电；	vi.  打闪；	
likely	[ˈlaɪkli]	adj.  可能的； 适合的； 有希望的；	adv.  可能； 或许； 大概； 多半	
likewise	[ˈlaɪkwaɪz]	adv.  同样地； 也，而且；	
limb	[lɪm]	n.  肢，翼； 大树枝； 分支； 枝干	vt.  割断…的四肢，肢解； 砍树枝；	
limitation	[ˌlɪmɪˈteɪʃn]	n.  限制； 局限； 极限； 起限制作用的规则（或事实、条件）	
limited	[ˈlɪmɪtɪd]	adj.  有限的； （君主权力）受宪法限制的； 〈美〉乘客名额有限制的； （智力，能力等）有限的	n.  高级快车； 直达的火车或汽车；	
link	[lɪŋk]	n.  环，节； [计算机]链接； 关联，关系；	vt.  连结； 挽住，勾住；	vi.  用环连接； 联系在一起；	
liquid	[ˈlɪkwɪd]	n.  液体； 流音；	adj.  液体的； 清澈的； （声音）流畅的； 易转换成现款的	
liquor	[ˈlɪkə(r)]	n.  酒，烈性酒； 含酒精饮料；	vt.  浸泡； 喝酒；	
liter	['li:tə(r)]	n.  [计量] 公升（容量单位）；	
literary	[ˈlɪtərəri]	adj.  文学（上）的； 精通文学的； 爱好文学的； 从事文学研究（或写作）的	
literature	[ˈlɪtrətʃə(r)]	n.  文学； 文学作品； 文献； 著作	
liver	[ˈlɪvə(r)]	n.  肝脏； （食用）肝； 深赤褐色； 生活者	adj.  肝味的； 深赤褐色的；	
living-room	['lɪvɪŋ'ru:m]	n.  客厅，起居室；	
loaf	[ləʊf]	n.  一条（块）面包；	v.  游荡； 游手好闲；	
loan	[ləʊn]	n.  贷款； 借款； 借用；	vt.  借，借给；	vi.  借出；	
lobby	[ˈlɒbi]	n.  门厅，大厅； 休息室； 游说团； 投票厅	vi.  为了支持或抵制某项特定目标游说；	vt.  对…进行游说； 陈情（试图努力影响某人采取有利行动）；	
local	[ˈləʊkl]	adj.  地方的； 当地的，本地的； 局部的； 褊狭的	n.  慢车； 本地居民（律师、教士、医生）； 住处附近的当地酒店； 本地新闻	
locate	[ləʊˈkeɪt]	vt.  位于； 说出来源； 查找…的地点； 确定…的位置	vi.  定位； 定居；	
location	[ləʊˈkeɪʃn]	n.  位置，场所； 定位； 外景（拍摄地）；	
lodge	[lɒdʒ]	vi.  存放； 暂住； 埋入； （权利、权威等）归属	vt.  提出（报告、要求、申诉等）； 容纳； 寄存； 把（权利、权威等）授予	n.  小屋，草屋； （北美印第安人的）帐篷； （森林、猎场等的）看守小屋； （学校、工厂等的）传达室	
log	[lɒg]	n.  记录； 日志； 原木；	v.  伐木； 把…载入正式记录； 行驶；	
logic	None	None	
logical	[ˈlɒdʒɪkl]	adj.  逻辑（上）的； 符合逻辑的； 推理正确的； 合乎常理的	
loop	[lu:p]	n.  圈，环； [医]宫内避孕环； 回路； 弯曲部分	vt.& vi.  （使）成环，（使）成圈； 以环连结； 使翻筋斗；	
loose	[lu:s]	adj.  松的，宽的； 模糊的； 散漫的； 自由的	vt.  释放； 不受约束地表达； 松开； 射出（子弹、箭等）	vi.  变得松散； 发射导弹； 开火；	adv.  散漫地；	n.  解放； 放任； 发射；	
loosen	[ˈlu:sn]	vt.  解开或使松； 放宽，放松； 使（肠）通畅；	vi.  变松或变得更松；	
lord	[lɔ:d]	n.  主； 领主； 上帝； （英国用以称呼法官、主教或某些男性贵族成员，表示尊敬）大人	vi.  逞威风；	
lorry	[ˈlɒri]	n.  运货汽车，机动卡车；	
lover	[ˈlʌvə(r)]	n.  爱好者，嗜好者； 情人； 情妇，情夫； 情侣	
numerous	[ˈnju:mərəs]	adj.  很多的，许多的； 数量庞大的； 数不清的；	
nursery	[ˈnɜ:səri]	n.  婴儿室，幼儿园； 苗圃； 临时托儿所； 温床，滋生地	
nylon	None	None	
obey	[əˈbeɪ]	vt.& vi.  服从，听从；	vt.  遵守，遵循；	
object	[ˈɒbdʒɪkt]	n.  物体； 目标； 宾语； 客体，对象	
objection	[əbˈdʒekʃn]	n.  反对； 反对的话，异议； 反对的理由；	
objective	[əbˈdʒektɪv]	adj.  客观的，实体的； 目标的； [语]宾格的； [医]他觉的	n.  目标，任务； [光]物镜； [语]宾语，宾格； [事]出击目标	
obligation	None	None	
oblige	[əˈblaɪdʒ]	vt.  强制，强迫； 使负债务； 使感激； 施惠于	vi.  施恩惠； 帮忙，效劳；	
observation	[ˌɒbzəˈveɪʃn]	n.  观察； 观察力； 评论； 观察所得	
observe	[əbˈzɜ:v]	vt.& vi.  观察； 研究；	vt.  遵守； 观察； 庆祝；	vi.  注意； 说； 评述； 当观察员	
observer	[əbˈzɜ:və(r)]	n.  遵守者，观察者； 观察团； 观察员；	
obstacle	[ˈɒbstəkl]	n.  障碍（物）； 障碍物（绊脚石，障碍栅栏）；	
obtain	[əbˈteɪn]	vt.  获得，得到； 流行； 买到，达到（目的）；	vi.  通行，通用； 流行； 存在；	
obvious	[ˈɒbviəs]	adj.  明显的； 显著的； 平淡无奇的； 自明	
occasion	[əˈkeɪʒn]	n.  机会，时机； 场合； 理由； 需要	vt.  惹起，引起；	
occasional	[əˈkeɪʒənl]	adj.  偶尔的，不经常的； 特殊场合的； 临时的；	
occupation	[ˌɒkjuˈpeɪʃn]	n.  职业，工作； 占有，占领； （土地、房屋、建筑等的）使用；	
occupy	[ˈɒkjupaɪ]	vt.  占领； 使用，住在…； 使从事，使忙碌； 任职	
occur	[əˈkɜ:(r)]	vi.  发生； 出现； 闪现；	
occurrence	[əˈkʌrəns]	n.  发生，出现； 遭遇，事件；	
odd	[ɒd]	adj.  古怪的； 奇数的； 剩余的； 临时的	n.  奇特的事物； 怪人； [高尔夫球]多于对方的一次击球；	
offend	[əˈfend]	vt.  触怒； 得罪，冒犯； 使反感令人不适；	vi.  犯规，触犯；	
offense	[əˈfens]	n.  进攻； （球队的）前锋； 进攻方法； 攻势 冒犯；犯罪；	
offensive	[əˈfensɪv]	adj.  无礼的，冒犯的，唐突的； 讨厌的，令人不快的； 进攻（性）的，攻击的，攻势的；	n.  进攻，攻势；	
official	[əˈfɪʃl]	n.  行政官员； 公务员； [体]裁判； 高级职员	adj.  官方的，法定的； 公职的，公务的； 官气十足； 正式的	
omit	[əˈmɪt]	vt.  省略； 遗漏； 删掉； 未（做）	
onion	[ˈʌnjən]	n.  洋葱（头）；	
opening	[ˈəʊpnɪŋ]	n.  开幕，开始； 空缺的职位； [商]开盘，交易开始时间； （职位的）空缺	adj.  首次的，开始的；	v.  （打）开( open的现在分词)； 开始； 睁开； 启动	
opera	[ˈɒprə]	n.  歌剧； 歌剧艺术， 歌剧业； 作品( opus的名词复数 )； 砌	
operational	[ˌɒpəˈreɪʃənl]	adj.  即可使用的； （用于）操作的； 经营的； 军事行动的	
operator	[ˈɒpəreɪtə(r)]	n.  经营者； 操作员； 电话接线员； 运算符	
opponent	[əˈpəʊnənt]	n.  对手； 反对者； 敌手；	adj.  对立的； 敌对的；	
opportunity	[ˌɒpəˈtju:nəti]	n.  机会； 适当的时机良机； 有利的环境，条件；	
oppose	[əˈpəʊz]	vt.& vi.  反对，抗争； 使相对； 使对照； 抵制	
optical	[ˈɒptɪkl]	adj.  视觉的，视力的； 眼睛的； 光学的；	
optimistic	[ˌɒptɪˈmɪstɪk]	adj.  乐观的，乐观主义的；	
option	[ˈɒpʃn]	n.  选择（的自由）； 选项； 选择权； 选择能力	vt.  得到或获准进行选择； 调动球员；	
optional	[ˈɒpʃənl]	adj.  可选择的； 随意的，任意的； 非强制的； 选修科目	
oral	[ˈɔ:rəl]	adj.  口头的，口述的； 口服的； 属于或关于嘴的； 构成或使用言语的	n.  （尤指外语考试中的）口试；	
orbit	[ˈɔ:bɪt]	n.  轨道； 势力范围； 眼眶； （人生的）旅程，生活过程	vt.& vi.  在…轨道上运行，环绕轨道运行；	vi.  盘旋； 绕轨道运行；	vt.  绕轨道而行； 进入轨道；	
orchestra	[ˈɔ:kɪstrə]	n.  管弦乐队； 管弦乐队的全部乐器；	
orderly	[ˈɔ:dəli]	adj.  整齐的，有秩序的； 有组织的，有规则的； [军]值班的； 安静的	n.  [军]传令下士； 传令兵； 街道清洁工；	adv.  依次地，顺序地； 有规则地； 有条理地；	
ore	[ɔ:(r)]	n.  矿； 矿石，矿砂；	
organ	[ˈɔ:gən]	n.  机构； 器官； 风琴； 元件	
organic	[ɔ:ˈgænɪk]	adj.  有机（体）的； 有组织的，系统的； 器官的； 根本的	
organize	[ˈɔ:gənaɪz]	v.  组织； 安排； 规划； 建立组织	
organization	[ˌɔ:gənaɪˈzeɪʃn]	n.  组织； 机构； 团体；	adj.  有组织的；	
organism	[ˈɔ:gənɪzəm]	n.  有机体； 生物体； 微生物； 有机体系，有机组织	
origin	None	None	
original	[əˈrɪdʒənl]	adj.  原始的； 独创的； 最初的； 新颖的	n.  原文； 原型； 原件； 怪人	
ounce	[aʊns]	n.  盎司； 少量，一点儿； 雪豹；	
outcome	[ˈaʊtkʌm]	n.  结果； 成果； 出路；	
outer	[ˈaʊtə(r)]	adj.  外面的，外部的； 远离内部（中心）的； [哲]客观外界的，物质的；	n.  环外命中；	
outlet	[ˈaʊtlet]	n.  经销店； 专营店； 排放管，出口； 发泄（情感）的途径	
outline	[ˈaʊtlaɪn]	n.  梗概，大纲，提纲，草稿，要点，主要原则； 外形，轮廓，轮廓线，轮廓画法，略图（画法）；	vt.  概述； 略述； 画轮廓，打草图，描略图；	
outlook	None	None	
output	[ˈaʊtpʊt]	n.  产量； 输出； 作品； [计]输出信号	vt.  输出；	
outset	[ˈaʊtset]	n.  开始，开端；	
outside	[ˌaʊtˈsaɪd]	adv.  在外面； 向外面； 在户外； 露天	n.  外面； （弯曲路面或轨道的）外道； （靠近路中央的）外侧； （建筑物等的）周围	adj.  外部的； 集团外的； （选择余地、可能性等）非常小； 可能性最大的	prep.  （表示位置）在[向]…的外面； （表示范围）超出…的范围； （表示排斥）除了（某人）；	
outstanding	[aʊtˈstændɪŋ]	adj.  杰出的； 显著的； 凸出的； 未完成的	
outward	None	None	
oval	[ˈəʊvl]	adj.  椭圆形的； 卵形的；	n.  椭圆形； 椭圆运动场（等）； 椭圆，美式足球用球； [物]卵形线	
oven	[ˈʌvn]	n.  烤箱，烤炉，灶；	
overall	[ˌəʊvərˈɔ:l]	adj.  全部的； 全体的； 一切在内的； 综合的	adv.  全面地； 总地； 总的说来；	n.  工装裤； 罩衫； 〈英〉（军官的）紧身军裤；	
overcome	[ˌəʊvəˈkʌm]	vt.& vi.  战胜，克服； 压倒，制服，…不堪；	vt.  被（烟、感情等）熏[压]倒，使受不了；	vi.  受到…的极大影响；	
overhead	[ˌəʊvəˈhed]	adj.  上面的，高架的； 头顶上的； （费用、开支等）经常的，管理的；	adv.  在头顶上； 在空中； 在楼上； 向上	n.  经常性支出，运营费用（常用复数 overheads）； （用于高射投影仪的）透明胶片； （飞机的）顶舱； 天花板	
overlook	[ˌəʊvəˈlʊk]	vt.  忽视，忽略； 瞭望； 检查； 远眺 俯瞰；	n. .  忽视； 眺望； 从高处能看到的景色； 鸟瞰图	
overnight	[ˌəʊvəˈnaɪt]	adv.  在晚上； 在夜里； 突然； 很快	adj.  一整夜的； 晚上的； 突然的； 很快的	n.  前一天的晚上； 一夜的逗留；	vi.  过一夜；	
overseas	[ˌəʊvəˈsi:z]	adv.  在[向]海外，在[向]国外；	adj.  （在）海外的，（在）国外的； （向或来自）外国的；	
overtake	[ˌəʊvəˈteɪk]	vt.  追上，赶上； 压倒； （不愉快的事）突然降临；	
owe	[əʊ]	vt.  欠…债； 感激； 应归功于； 怀有情感	
owing	[ˈəʊɪŋ]	adj.  欠着的，应付的，未付的；	v.  感激( owe的现在分词 )； 应把…归功于； 欠…债； （对位高权重者）忠诚	
owner	[ˈəʊnə(r)]	n.  物主，所有人；	
ownership	[ˈəʊnəʃɪp]	n.  物主身份； 所有权； 所有制； 所有	
oxygen	[ˈɒksɪdʒən]	n.  [化]氧，氧气；	
pace	[peɪs]	n.  一步； 长度单位； 步幅，步调； 快步	vt.  踱步，走来走去； 步测； 调整步调； 训练马溜蹄	vi.  踱； 溜蹄；	prep.  蒙…恩准，怀着对…的敬意；	
pack	[pæk]	n.  一群； 包裹； （纸牌的）一副； 一组	vt.& vi.  （把…）打包； 塞进； 拥进； （使）聚集成团	vt.  挑选； 压紧； 携带； 拧紧	vi.  包装； 紧挤在一起； 便于折叠收藏的； 匆忙离去（有时与 off 连用）	
package	[ˈpækɪdʒ]	vt.  包装； 把…装箱； 向…提出一揽子计划；	n.  包裹； 包装袋； 包装盒； 一组建议	
packet	[ˈpækɪt]	n.  小包； 信息包； 邮船； 大笔款项	vt.  包装，打包； 用邮船运送；	
pad	[pæd]	vt.  给…装衬垫， 加垫子； 填塞； 踏平；	vi.  步行，放轻脚步走；	n.  垫，衬垫； 护具； 便签本； 发射台	
prompt	[prɒmpt]	adj.  敏捷的； 迅速的； 立刻的； 准时的	v.  促使； 导致； 鼓励； 提示	n.  激励； 提示符； 提词； 提示	adv.  准时地；	
pronoun	[ˈprəʊnaʊn]	n.  代词；	
proof	[pru:f]	n.  证明； 校样； 检验； （酒的）标准酒精度	adj.  防…的； 抗…的； 能抵御； 能防范	vt.  给（织物）做防护处理，使防水（或防火等）； 印…的校样；	vi.  [印刷术] 校对； 发酵；	
property	[ˈprɒpəti]	n.  财产； 房地产； 特性； 属性	
proportion	[prəˈpɔ:ʃn]	n.  部分，份额； 比例； 匀称； 面积，规模	
proportional	[prəˈpɔ:ʃənl]	adj.  比例的，成比例的； 相称的，均衡的；	n.  [数]比例项，比例量；	
proposal	[prəˈpəʊzl]	n.  提议； 建议； 求婚； 〈美〉投标	
propose	[prəˈpəʊz]	vt.  提议，建议； 打算，计划； 推荐，提名； 求婚	vi.  做出计划，打算； 求婚；	
prospect	[ˈprɒspekt]	n.  前景； 期望； 眺望处； 景象	vi.  勘探； 勘察； （矿等）有希望； 有前途	vt.  找矿； 对…进行仔细调查；	
prosperity	[prɒˈsperəti]	n.  繁荣； 兴旺，昌盛； 成功；	
prosperous	[ˈprɒspərəs]	adj.  繁荣的，兴旺的； 富裕的； 幸福的，运气好的； 良好的	
protection	[prəˈtekʃn]	n.  保护； 护照； [经]保护贸易制，保护政策； （向歹徒缴纳的）保护费	
protective	[prəˈtektɪv]	adj.  保护的，防护的； 保护贸易的；	
protein	[ˈprəʊti:n]	n.  [化]朊，蛋白（质）；	adj.  蛋白质的；	
protest	[ˈprəʊtest]	n.  抗议； 反对； 申明；	
prove	[pru:v]	vt.  证明，证实； [法]验证，检定； 显示；	vi.  显示出，证明是；	
provide	[prəˈvaɪd]	vt.& vi.  提供，供给，供应；	vt.  规定； 提供(+for)； 装备； 预备	vi.  抚养，赡养(+for)； 做准备； 预约(for 或 against)；	
provided	[prəˈvaɪdɪd]	conj.  如果； 假如； 在…的条件下；	v.  提供，供给( provide的过去式和过去分词)；	
province	[ˈprɒvɪns]	n.  省份； 大行政区； 范围； 职责	
provision	[prəˈvɪʒn]	n.  规定，条项，条款； 预备，准备，设备； 供应，（一批）供应品； 生活物质，储备物资	vt.& vi.  为…提供所需物品（尤指食物）；	
provoke	[prəˈvəʊk]	vt.  激起，挑起； 煽动； 招致； 触怒，使愤怒	
psychological	[ˌsaɪkəˈlɒdʒɪkl]	adj.  心理的； 精神上的，精神（现象）的； 心理学（上）的； 关于心理学的	
publication	None	None	
publicity	[pʌbˈlɪsəti]	n.  公众信息； 宣传效用； 宣传； 公诸于众的状况 广告；注意；	
publish	[ˈpʌblɪʃ]	vt.& vi.  出版，发行； 发表，宣布（结婚等）； 公布，颁布； 出版…的著作	
pulse	[pʌls]	n.  脉搏； [无线电]（电磁波等）脉动； 活力； 有节奏的跳动（或拍打）	vi.  （心脏）跳动； 脉动； 搏动； 震动	vt.  使跳动； 有节奏地驱动（机器等）； [电子学]施以脉冲； [无线电]脉冲地调节（电磁波）	
pump	[pʌmp]	n.  泵； 打气筒； 轻软舞鞋； 轻便帆布鞋（英式英语）	vt.& vi.  用抽水机汲水； 给…打气； 用泵（或泵样器官等）输送； 涌出	vt.  用泵抽； 注入，似用泵来拉、转或倒； 抽水，从。。除去水； 骑自行车的人上下蹬踏板	
punch	[pʌntʃ]	v.  用拳猛击； （用压穿器）穿孔，冲孔； 挤；按（键），压（按钮）；	n.  重拳击打； 打孔机； 冲床； 影响力	
punctual	[ˈpʌŋktʃuəl]	adj.  严守时刻的， 准时的，正点的；	
purchase	[ˈpɜ:tʃəs]	v.  购买； 采购； 换得； 依靠机械力移动	n.  购买； 购买行为； 购置物； 紧握	
purple	[ˈpɜ:pl]	adj.  紫色的； 帝王的； 词藻华美的；	n.  紫色； 紫（红）衣，紫袍； 帝位，皇权； 皇族	vt.  使成紫色；	vi.  变紫；	
purse	[pɜ:s]	n.  钱包，钱袋； 财力，财源； 和包或钱袋相似的东西； 女用小提包	vt.  使皱起，噘起；	
pursue	[pəˈsju:]	vt.  继续； 追求； 进行； 追捕	vi.  追，追赶； 继续进行；	
puzzle	[ˈpʌzl]	vt.  使迷惑，使难解；	vt.& vi.  为难，伤脑筋；	n.  智力测验，智力玩具； 难题； 令人费解的事[人]； 谜一般的事物	
qualification	[ˌkwɒlɪfɪˈkeɪʃn]	n.  资格，授权； 条件，限制； 合格证书；	
qualify	[ˈkwɒlɪfaɪ]	vt.& vi.  （使）具有资格； 有权； 达标；	vt.  限定，修饰； 描述，形容； 使合适； 证明…合格	vi.  合格或成为合格； 取得…的资格；	
queue	[kju:]	n.  （人或车辆）行列，长队； 辫子；	vi.  （人、车等）排队等候；	vt.  （使）排队，列队等待；	
quit	[kwɪt]	vt.  离开； 放弃，抛弃； 停止，中断； 偿清	vi.  停止； 放弃斗争； 辞职；	adj.  自由的； 摆脱了责任或义务的；	
quiz	[kwɪz]	n.  提问，询问； 小型考试； 简单的小测验； 恶作剧	vt.  盘问； 挖苦； 进行测试； 张望	
quotation	[kwəʊˈteɪʃn]	n.  引用，引证； [商业]行情，行市； 行市表，估价单； 引用语	
quote	[kwəʊt]	vt.& vi.  引述，引用；	vt.  报价； 引述；	vi.  引用；	n.  引用； 报价； 引号；	
racial	[ˈreɪʃl]	adj.  种族的； 人种的； 存在或发生于种族之间的；	
rack	[ræk]	n.  行李架； 支架； 刑架； （羊、猪等带前肋的）颈脊	vt.  使痛苦，使焦虑； 剥削，榨取； 用刑拘折磨；	
radar	[ˈreɪdɑ:(r)]	n.  雷达； 雷达装置； 无线电探测器；	
radiation	[ˌreɪdiˈeɪʃn]	n.  辐射； 放射物； 辐射状； 分散	
radical	[ˈrædɪkl]	adj.  根本的，基本的； 激进的； 彻底的； [植]根生的	n.  激进分子； 根基，原子团； [数学]根数；	
rag	None	None	
rage	[reɪdʒ]	n.  愤怒； 激烈，猛烈； 渴望，疯狂； 〈口〉战争狂	vi.  大发脾气，动怒； 流行，风行；	
raid	[reɪd]	n.  （骑兵队等的）急袭，突然袭击，突击，（军舰等的）游击； 劫掠，劫夺，（盗贼，狐等的）侵入； 突然查抄[搜捕]，围捕；	vi.  对…进行突然袭击； 进行奇袭；	vt.  突然袭击[抢劫]； 突然搜查； 劫掠； 打劫	
rail	[reɪl]	n.  围栏； 轨道，钢轨； 扶手； [动]秧鸡	vi.  责备； 抱怨； 责骂；	vt.  将…围起来； 铺铁轨； 坐火车旅行； 用围栏围	
railroad	[ˈreɪlrəʊd]	n.  铁路； 铁道； 铁路公司； 铁路部门	v.  迫使…仓促行事； 强迫…做； 轻率判处；  在铁路工作；乘火车旅行	
railway	[ˈreɪlweɪ]	n.  铁路； 铁道； 铁路系统； 铁道部门	vi.  乘火车旅行； 在…铺设铁路；	
rainbow	[ˈreɪnbəʊ]	n.  彩虹；	adj.  五彩缤纷的； 彩虹状的；	vt.&vi.  使呈彩虹状；	
rally	None	None	
range	[reɪndʒ]	n.  范围； 射程； 类别； （山脉，房屋等的）排列	vi.  变化； 包括； 涉及；	vt.  排列； 徘徊；	
rank	[ræŋk]	n.  阶层，等级； 军衔； 次序，顺序； 行列	vt.& vi.  排列，使成横排； 把…分类；	vt.  排列； 超过，高于； 把…分等级；	vi.  位于； 使成横排； 抱怨； 吹毛求疵，揭疮疤	adj.  讨厌的； 极端的； 繁茂的； 恶臭的	
rare	[reə(r)]	adj.  罕见的，特殊的； 半熟的；半生的； 稀薄的，经过稀化的； 三分熟	
rarely	[ˈreəli]	adv.  很少地； 罕有地； 极精彩地； 珍奇地，绝佳地	
rat	[ræt]	n.  大老鼠； 似鼠动物； 鼠辈，卑鄙小人；	vi.  捕鼠； 背叛，告密；	
rate	[reɪt]	n.  速度； 比率； 等级； （利息等的）费率	vt.  估价； 值得； 责骂； 定级	vt.& vi.  认为，把…算作；	vi.  被评价； 被认为； 被列入； 申斥	
ratio	[ˈreɪʃiəʊ]	n.  比，比率； 比例； 系数；	vt.  求出比值，除，使…成比例； 将（相片）按比例放大[缩小]；	
rational	[ˈræʃnəl]	adj.  神智清楚的； 理性的； 理智的； 合理的	n.  合理的事物； [数]有理数； 懂道理的人，人类； 〈英〉合理的服装	
raw	[rɔ:]	adj.  生的，未加工的； 无经验的； 新近完成的； 发炎的，疼痛的	vt.  擦伤； 使赤身露体；	n.  （身体的）擦伤部位； 红肿部位； 半成品； 原料	
react	[riˈækt]	vi.  反应，作出反应； 影响； 起反作用；	vt.  使发生相互作用； 使起化学反应； 反抗； 再演，重演	
reaction	[riˈækʃn]	n.  反应； 反作用力； 反动； 保守	
readily	[ˈredɪli]	adv.  乐意地； 快捷地； 轻而易举地； 便利地	
realistic	[ˌri:əˈlɪstɪk]	adj.  现实的； [艺] 现实主义的，[哲]实在论（者）的； 逼真的； 栩栩如生的	
reality	[riˈæləti]	n.  现实，现实性； 真实情况，实际情形； 实体，实在； 事实	
realm	[relm]	n.  领域，范围； 王国； （学术的）部门，界； （动植物分布的）圈，带	
rear	[rɪə(r)]	vt.  饲养； 养育； 抚养；	vt.& vi.  抬起；	n.  后部，背面，背后； 臀部； （舰队或军队的）后方，后尾，殿后部队； 〈英口〉厕所	vi.  直立； 高耸；	adj.  后面的，后部的；	
reasonable	[ˈri:znəbl]	adj.  合理的，公道的； 明白道理的； 适当的； 有理性的	
rebel	[ˈrebl]	n.  反政府的人； 反叛者； 造反者； 叛逆者	adj.  反抗的； 造反的；	
recall	[rɪˈkɔ:l]	vt.  叫回，召回； 使想起，回想； 取消； 调回工厂	n.  召回，唤回； 记忆力，回想； 罢免； 收回通告	
receipt	[rɪˈsi:t]	n.  收据，发票； 收入；	vt.  开收据； [美国英语]给…开收据，承认收到；	
receiver	[rɪˈsi:və(r)]	n.  接受者，收款员； 接收器； 无线电接收机； （破产公司的）官方接管人	
recently	[ˈri:sntli]	adv.  最近，近来； 不久以前； 近日； 新近	
reception	[rɪˈsepʃn]	n.  接待； 欢迎； 招待会； 接待处	
recession	[rɪˈseʃn]	n.  经济衰退，不景气； 后退，撤退； 凹处； 退场	
reckon	[ˈrekən]	vt.  测算，估计； 认为； 计算； 评定，断定	vi.  计算； 估计； 猜想； 料想	
recognition	[ˌrekəgˈnɪʃn]	n.  认识，识别； 承认，认可； 褒奖； 酬劳	
recognize	[ˈrekəgnaɪz]	vt.  认出； 识别； 承认；	vi.  承认，确认； [法律]具结，立保证书；	
scholarship	[ˈskɒləʃɪp]	n.  奖学金； 学术； 学识；	
scientific	[ˌsaɪənˈtɪfɪk]	adj.  科学的； 有系统的； 应用科学的； 精通学理的，有学问的	
scissors	[ˈsɪzəz]	n.  剪刀； 两腿前后错跃；	v.  剪开( scissor的第三人称单数)； 作剪式移动（尤指腿）；	
scold	[skəʊld]	vt.  责骂；	vi.  责骂； 斥责；	n.  常骂人的人；	
scope	[skəʊp]	n.  （处理、研究事务的）范围； 眼界，见识； （活动或能力的）余地； 广袤，地域	v.  审视，仔细研究；	
score	[skɔ:(r)]	n.  得分； 分数； 总谱； 20个	v.  得分； 记分； 评分； 获得胜利	
scout	[skaʊt]	n.  搜索，侦察； 侦察员， 侦察机， 侦察舰 , 童子军； （牛津大学的）校工；	vt.  侦察； 跟踪，监视； 发现；	vi.  侦察； 巡视； 嘲笑；	
scrape	[skreɪp]	vt.  擦，刮； 擦去； 擦伤，刮破； 挖空	vi.  刮，擦； 搔，抓； 掏； 发出刺耳的声音	n.  擦，刮； 刮痕； 刮擦声； 刮胡子，修面	
scratch	[skrætʃ]	vt.  擦，刮； 擦痛，擦伤； 在…处搔痒； 抓破	vi.  发出刮擦声； 擦红，擦伤； 搔痒； 抓，扒	n.  擦，刮； 刮擦声； 搔痕； 乱写乱画	adj.  打草稿用的，随便写用的； 碰巧的，侥幸的； 东拼西凑的； 平等比赛的	
scream	[skri:m]	vt.  尖声喊叫，拼命叫喊； 喊叫着说出； 尖叫得使变…；	vi.  尖叫； 发出尖锐刺耳的声音；	n.  尖叫声，惊叫声； 拼命的叫喊声； 极其滑稽可笑的人；	
screen	[skri:n]	n.  屏幕； 银幕； 屏风；	vt.  筛（煤、矿石等）； 拍摄； 放映（电影）； 庇护	
screw	[skru:]	n.  螺丝钉； 螺旋桨，螺旋状物； （螺丝的）转，扭； 吝啬鬼	vt.  用螺丝拧紧； 扭曲（某人的面孔）； 〈俚〉占便宜，诈骗；	vi.  扭转，扭歪； 旋紧； （和某人）性交；	
script	[skrɪpt]	n.  脚本，手迹； 书写体铅字； 剧本、广播稿或者电影剧本；	vt.  为电影（或戏剧等）写剧本； 编造；	
seal	[si:l]	n.  密封； 印章； 海豹； 封条	v.  密封； 盖章； 决定； 封上（信封）	
secondary	[ˈsekəndri]	adj.  第二的，中等的； 助手，副手； 中等教育的； 间接的	n.  副手，代理人； [天]双星中较小较暗的一个，卫星； [语]次重音；	
section	[ˈsekʃn]	n.  部分； 节； 部件； 部门	vi.  切开； 切断； 做（动物或植物组织）切片； 把（精神病患者）正式送入精神病院	vt.  把…切成片（或段）； 作…的切片； 把…作成截面； 制作…的剖面图	
sector	[ˈsektə(r)]	n.  部门； 领域； 防御地区； 扇形	
secure	[sɪˈkjʊə(r)]	adj.  安全的； 牢固的； 有把握的； 安心的	vt.  保护； （使）获得； 使安全； 担保	vi.  获得安全，变得安全； 安全，保险； 承保，担保； [航海学]停止工作	
security	[sɪˈkjʊərəti]	n.  安全； 保证，担保； 保护，防护； 有价证券	adj.  安全的，保安的，保密的；	
segment	[ˈsegmənt]	n.  部分，段落； 环节； [计算机]（字符等的）分段； [动物学]节片	vt.&vi.  分割，划分； [生]使分裂；	
select	[sɪˈlekt]	vt.  选择； 挑选； 选拔； （在计算机屏幕上）选定；（从菜单中）选取	adj.  精选的； 挑选出来的； 优等的； 第一流的 苛责的；（地点）仅供精英阶层专用的；有辨别能力的；	n.  被挑选者；	
selection	[sɪˈlekʃn]	n.  选择； 被选中者； 可供选择的事物；	
selfish	[ˈselfɪʃ]	adj.  自私的，利己的；	
semester	[sɪˈmestə(r)]	n.  （尤指美国的大专院校的）学期； 半学年；	
semiconductor	[ˌsemikənˈdʌktə(r)]	n.  半导体；	
seminar	[ˈsemɪnɑ:(r)]	n.  研讨班，讲习会； 研讨小组； 研讨会； 培训会	
senate	[ˈsenət]	n.  参议院（美国、法国、澳大利亚等国家的两个立法机构之一）； 上院； 某些国家的)大学理事会； 大学评议会	
senator	[ˈsenətə(r)]	n.  参议员；	
senior	[ˈsi:niə(r)]	adj.  （级别、地位等）较高的； 资深的； 年长的； 最高年级的	n.  上级； 毕业班学生； 较年长者； 地位较高的，资历较深的	
sensible	[ˈsensəbl]	adj.  明智的； 合乎情理的； 通情达理的； 意识到的，能感觉到的	n.  可感觉到的东西； 敏感的人；	
sensitive	[ˈsensətɪv]	adj.  敏感的； 感觉的； [仪]灵敏的； 易受影响的	n.  敏感的人； 有灵异能力的人；	
sequence	[ˈsi:kwəns]	n.  [数]数列，序列； 顺序； 连续； 片断插曲	vt.  使按顺序排列，安排顺序； [生化]确定…的顺序，确定…的化学结构序列；	
series	[ˈsɪəri:z]	n.  系列，连续； 串联； （广播或电视上题材或角色相同的）系列节目； 级数	
session	[ˈseʃn]	n.  （议会等的）会议，会期； （法庭的）开庭； （某项活动的）一段时间，一场，一节； 学年	adj.  （音乐家）伴奏的；	
setting	[ˈsetɪŋ]	n.  镶嵌； 环境； 装置； （某事、戏剧、小说等的）背景	v.  放( set的现在分词)； 安插； 树立； 安排	
settle	[ˈsetl]	vt.  解决； 安排； 使定居； 使沉淀	vi.  下沉； 定居；	n.  高背长靠椅；	
settlement	[ˈsetlmənt]	n.  解决； 结算； 金钱或财产的转让（契约）； 沉淀 定居点；	
severe	[sɪˈvɪə(r)]	adj.  严峻的； 严厉的； 剧烈的； 苛刻的	
sew	[səʊ]	vt.& vi.  缝，做针线活； 缝纫； 装钉（书籍）；	
sexual	[ˈsekʃuəl]	adj.  性的，有性别的； 性欲的； 生殖的； [生]有性的	
shallow	[ˈʃæləʊ]	adj.  浅的，肤浅的； 表面的，皮毛的； （水，器物等）浅的； （呼吸）浅的	n.  浅处； 浅滩；	v.  使变浅； 使变浅薄；	
shave	[ʃeɪv]	vt.& vi.  剃须，剃毛；	vt.  剃，削去； 修剪； 切成薄片； 掠过	n.  刮脸，剃胡子； 修面； 侥幸逃过，幸免； 剃刀，刮刀	
shed	[ʃed]	n.  棚，库； 分水岭；	vt.  流出； 流下； 蜕皮； 树叶脱落	vi.  流出； 蜕皮； 脱落； 散布	
sheer	[ʃɪə(r)]	v.  （使）偏航，（使）转向；	adv.  完全地，全然； 垂直地，陡峭地；	n.  舷弧； 单锚系泊的船位； 偏离的方向； 船体型线	adj.  完全的，全然的； 极薄的； 几乎垂直地，陡峭的； 绝对的	
shell	[ʃel]	n.  （贝、卵、坚果等的）壳； 外壳； 炮弹； （人的）表面性格	vt.  去壳，脱落； 炮击；	vi.  剥皮； 炮轰；	
shelter	[ˈʃeltə(r)]	n.  居所； 避难所； （无家可归者或受虐待者的）收容所； 遮蔽	vt.  掩蔽； 庇护； 保护；	vi.  躲避； 避难；	
shield	[ʃi:ld]	n.  盾； 护罩； 盾形奖牌； 保护人	vt.  保护； 掩护； 庇护； 给…加防护罩	
shift	[ʃɪft]	vt.& vi.  改变； 去掉； 摆脱掉； 换挡	vt.  换…的衣服，更（衣）； 卖，出售； [计算机]使（数据）位移；	vi.  （汽车）换挡； 换衣服； 蒙混； 自己谋生	n.  移动，转移，转换； 变迁，变化，变换，替换，更换，掉换，更易，代用； （汽车等的）变速；	
shiver	[ˈʃɪvə(r)]	n.  发抖，颤抖； 碎块，破片；	vi.  战栗，发抖；	vt.  由于航行时太靠近风而使（帆）颤动；	
shortage	[ˈʃɔ:tɪdʒ]	n.  不足，缺点； 缺少； 缺少量； 不足额	
shortcoming	[ˈʃɔ:tkʌmɪŋ]	n.  短处，缺点；	
shortly	[ˈʃɔ:tli]	adv.  立刻，马上； 简单地，扼要地； 唐突地，简慢地； 在即	
shrink	[ʃrɪŋk]	vt.& vi.  收缩，皱缩； （使）缩水； 退缩，畏缩；	n.  收缩； 畏缩； 精神病学家；	
shrug	[ʃrʌg]	vt.  耸肩（以表示冷淡，怀疑等）；	vi.  耸肩，提高肩膀；	n.  耸肩； 女式短茄克衫或前开襟毛线衫；	
sideways	[ˈsaɪdweɪz]	adv.  斜着，斜向一边； 以侧面对着；	adj.  斜向一边的；	
sigh	[saɪ]	vi.  叹气； 悲叹，悲鸣；	vt.  叹气地说；	n.  叹气，叹气声；	
sightseeing	[ˈsaɪtsi:ɪŋ]	n.  观光，游览；	
signal	[ˈsɪgnəl]	n.  信号，暗号； 预兆，征象； 动机； 导火线	vt.  向…发信号； 用动作（手势）示意； 以信号告知；	vi.  发信号；	adj.  显著的，优越的； 暗号的，作信号用的；	
signature	[ˈsɪgnətʃə(r)]	n.  签名； 署名； 识别标志，鲜明特征； [医]药的用法说明	
significance	[sɪgˈnɪfɪkəns]	n.  意义； 意思； 重要性；	
significant	[sɪgˈnɪfɪkənt]	adj.  重要的； 显著的； 有重大意义的； 意味深长的	
similar	[ˈsɪmələ(r)]	adj.  类似的； 同类的； 相似的； 同样的	n.  类似物； 相像的人； 相似物；	
similarly	[ˈsɪmələli]	adv.  相似地； 类似地； 同样； 也	
simplicity	[sɪmˈplɪsəti]	n.  简单，朴素； 质朴，天真； 卑贱； 无知	
simplify	[ˈsɪmplɪfaɪ]	vt.  简化； 使单纯； 使简易；	
sin	[sɪn]	n.  违背宗教[道德原则]的恶行； 罪恶，罪孽； 过错，罪过； 愚蠢的事，可耻的事	vi.  犯罪，犯过错；	vt.  犯罪；	
sincere	[sɪnˈsɪə(r)]	adj.  真诚的，诚挚的； 〈古〉纯粹的，不掺假的； 真心实意的； 真实的	
single	[ˈsɪŋgl]	adj.  单一的； （打斗、比赛等）一对一的； 惟一的； 适于一人的	n.  单程票； （旅馆等的）单人房间； [复数]（高尔夫球一对一的）二人对抗赛； [常用复数][美国、加拿大英语]未婚（或单身）男子（或女子）	vt.  挑选；	vi.  作一垒手；	
singular	None	None	
site	[saɪt]	n.  地点，位置，场所； [计算机]网站； 遗址； 地皮	vt.  使坐落在； 安放，设置； 给…造址； 为…提供场所	
sketch	[sketʃ]	n.  草图； 素描； 梗概；	v.  草拟； 速写； 简述；	
skilled	[skɪld]	adj.  熟练的，有经验的； 需要技能的； 专门的；	
skillful	['skɪlfʊl]	adj.  灵巧的，熟练的； 制作精巧的； 圆熟；	
skim	[skɪm]	v.  略读； 撇去； 使掠过； （为逃税而）隐瞒（部分收入）	adj.  脱脂的； 撇去浮沫的；	n.  撇； 撇去的东西； 瞒报所得的收入；	
slam	[slæm]	vt.  砰地关上（门或窗）； 猛烈抨击； 使劲一推； 猛劲一摔	vi.  砰然关上； 猛力打击，碰撞； 撞到了一辆卡车上；	n.  猛然关闭的声音； 猛击；	
slap	[slæp]	n.  掌掴； 掌掴声； 侮辱；	vt.  猛打； 用力放置； 尖刻批评、侮辱；	vi.  拍击；	adv.  直接地； 猛然地；	
sleeve	[sli:v]	n.  [机]套筒，套管； 袖子，袖套； 唱片套；	vt.  给…装袖子； 给…装套筒；	
slender	[ˈslendə(r)]	adj.  苗条的； 微薄的； 柔弱的；	
slice	[slaɪs]	vt.  切成片； 切下； 划分；	n.  薄片； 一部分； （因失误而打出的）曲线球；	vi.  斜击；	
slide	[slaɪd]	vi.  滑落； 下跌； 打滑； [棒球]滑垒	vt.  衰落（成）； 逐渐降低； 使悄悄转动； （使）快捷而悄声地移动	n.  幻灯片； 降低； 滑梯；	
slight	[slaɪt]	adj.  微小的； 细小的； 不结实的； 无须重视的	n.  轻蔑，忽视，冷落；	vt.  轻蔑，忽视，怠慢；	
synthetic	[sɪnˈθetɪk]	adj.  合成的； 人造的； 摹拟的，虚构的； [语]综合的	n.  合成物； 合成纤维； 合成剂；	
system	[ˈsɪstəm]	n.  体系，系统； 制度； 身体； 方法	
systematic(al)	None	None	
tackle	[ˈtækl]	n.  用具，装备； 索具； 阻挡； 阻截队员	vt.  着手处理； [橄榄球]擒住并摔倒（一名对方球员）； 给（马）配上挽具；	vi.  擒住并摔倒一名对手；	
tag	[tæg]	vt.  加标签于； 附加； 起诉； 紧跟	vi.  跟在…后面； 随从；	n.  标签； 附属物； 口头禅； 称呼	
talent	[ˈtælənt]	n.  天资，才能； 天才，人才； 塔兰特，古代的一种计量单位，可用来记重量或作为货币单位； 性感的人	
tame	[teɪm]	adj.  驯服的； 平淡的； 无精打采的；	v.  驯服； 抑制；	
target	[ˈtɑ:gɪt]	n.  （服务的）对象； 目标； （射击的）靶子； 目的	vt.  瞄准； 把…作为攻击目标；	
tax	[tæks]	vt.  使负担重； 消耗精力； 向…征税； 责备，谴责	n.  税，税额； 负担；	
technician	[tekˈnɪʃn]	n.  技术人员； 技师； 技巧纯熟的人；	
technique	[tekˈni:k]	n.  技巧； 技能； 技术； 技艺	
technology	[tekˈnɒlədʒi]	n.  科技（总称）； 工业技术； 工艺学； [总称]术语	
tedious	[ˈti:diəs]	adj.  单调沉闷的； 冗长乏味的； 令人生厌的；	
teenager	[ˈti:neɪdʒə(r)]	n.  十几岁的青少年； 十三岁到十九岁的少年；	
telescope	[ˈtelɪskəʊp]	n.  望远镜；	vt.& vi.  （使某物）变短（叠缩在一起）； （使某物）叠缩，嵌入；	vt.  压缩某物使其少占空间或时间；	
temper	[ˈtempə(r)]	n.  性情，脾气； 特征； （钢等）回火； 怒气	vt.  调和； 使回火； 锻炼； 缓和	vi.  使调和；	
temple	[ˈtempl]	n.  庙，寺； 耶路撒冷古神殿； [犹太教] 犹太教聚会； 太阳穴	
temporary	[ˈtemprəri]	adj.  临时的，暂时的； 短暂的；	n.  临时工，临时雇员；	
temptation	[tempˈteɪʃn]	n.  诱惑，引诱； 诱惑物；	
tend	[tend]	vt.  照料，照顾； 护理； 照管，管理；	vi.  倾向（于），趋向（于）； 伺侯，招待； 关心； 注意	
tendency	[ˈtendənsi]	n.  倾向，趋势； （话或作品等的）旨趣，意向； 性情； 癖好	
tender	[ˈtendə(r)]	adj.  纤弱的； 嫩的； 温柔的； 疼痛的	n.  （正式）提出； 投标； 供应船，联络船； 照看者	vt.  正式提出； 使变脆弱； 温柔地对待；	
tense	[tens]	adj.  拉紧的； 肌肉绷紧的； 神经紧张的； [语]（语音）紧的	n.  [语]时，时态； 〈古〉时间；	v.  使或变的紧张；	
tension	[ˈtenʃn]	n.  紧张，不安； 紧张气氛； [物]张力，拉力； 矛盾	vt.  紧张； 使紧张；	
terminal	[ˈtɜ:mɪnl]	adj.  末期的； 晚期的； 定期的； 末端的	n.  终端； 终点站； 航空站； （电路的）端子	
territory	[ˈterətri]	n.  领土，版图； 领地； 领域，范围； [商]势力范围	
terror	[ˈterə(r)]	n.  恐怖； 恐怖的缘由； 恐怖行为； 令人讨厌的人	
textile	[ˈtekstaɪl]	n.  纺织品，织物； 纺织业；	
theme	None	None	
theoretical	[ˌθɪəˈretɪkl]	adj.  理论的； 推想的，假设的； 空论的；	
theory	[ˈθɪəri]	n.  学说； 理论； 原理； 推测	
therapy	None	None	
thereby	[ˌðeəˈbaɪ]	adv.  由此，从而； 在那附近；	
therefore	[ˈðeəfɔ:(r)]	adv.  因此； 所以； 故； 乃	
thermometer	[θəˈmɒmɪtə(r)]	n.  温度计； 体温表；	
thick	[θɪk]	adj.  浓的，茂密的； 厚的，粗大的； 稠密的； 不透明的	adv.  密集地； 不清晰地； 〈口〉太过分； 频频地，时常	n.  最厚的部分； 最活跃或最激烈的部分； 〈口〉笨蛋； 〈俚〉可可粉	
thinking	[ˈθɪŋkɪŋ]	n.  思考； 想法，思想； 意见； 见解	adj.  有思想的； 有理性的；	v.  “think”的现在分词；	
thirsty	[ˈθɜ:sti]	adj.  口渴的； 渴望（求）…的； 干旱的，缺水的； 耗油的	
thorough	[ˈθʌrə]	adj.  彻底的，全面的，充分的，彻头彻尾的，根本的，详尽的，严密的； 十足的，考虑周到的； 非常精确的，（对细节）不厌其烦的； 绝对的，完善的	prep.  〈古〉同“through”；	n.  [英史]专横政策；	
thoughtful	[ˈθɔ:tfl]	adj.  沉思的； 体贴的； 缜密思考过的，深思熟虑的；	
threat	[θret]	n.  威胁； 恐吓； 凶兆；	
threaten	[ˈθretn]	vt.& vi.  预示（某事）； 恐吓； 危及； 预示凶兆	vi.  似将发生； 威胁；	
thrive	[θraɪv]	vi.  兴盛，兴隆； 长得健壮； 茁壮成长；	
throat	[θrəʊt]	n.  咽喉； 颈前部； [植物学]管颈；	vt.  用沙哑的声音或嗓音发音；	
thrust	[θrʌst]	vt.& vi.  猛推； 逼迫； 强行推入； 延伸	n.  刺； 推力； [军]突击； [地]逆断层	vi.  插入； 用力向某人刺去； 猛然或用力推；	
thumb	[θʌm]	n.  拇指； （手套的）拇指部份；	vi.  翘起拇指请求搭乘（过路汽车），示意请求搭便车； 翻阅；	vt.  翻阅； 作搭车手势； 用拇指翻脏[翻坏]（书页等）；	
thunder	[ˈθʌndə(r)]	n.  雷声； 隆隆的响声；	vi.  打雷；	vt.& vi.  发出隆隆声； 轰隆隆地快速移动； 使快速移动； 怒喝	
tide	None	None	
tidy	[ˈtaɪdi]	adj.  整洁的，整齐的； （数量）相当大的； 相当好的； 健康的	n.  盛零碎物品的容器； 椅子的背罩；	vt.& vi.  使整洁； 弄整齐； 使有条理； 整理，收拾	
timber	[ˈtɪmbə(r)]	n.  木材，木料； （用于建筑或制作物品的）树木； 用材林，林场； 素质	vt.  用木料支撑； 备以木材；	
tissue	[ˈtɪʃu:]	n.  薄纸，棉纸； [生]组织； 一套；	
title	[ˈtaɪtl]	n.  标题； 头衔； [体]冠军； [影视]字幕	vt.  加标题； 赋予头衔； 把…称为；	adj.  头衔的； 标题的； 冠军的；	
toast	None	None	
tolerance	[ˈtɒlərəns]	n.  宽容，容忍； 限度； 公差； 耐药量，耐药性	
tolerate	[ˈtɒləreɪt]	vt.  容许； 承认； 忍受； 容忍（不同意或不喜欢的事物）	
tone	[təʊn]	n.  [语]声调，语调； [画]色调，色泽，明暗； [乐]乐音，全音，全音程； [医]（正常的）健康状态	vt.  使更健壮； 定调； 使变调子； [摄影术]给…上色	vi.  带有某种腔调； 呈现某种色彩； （颜色）调和（与 with 连用）；	
topic	[ˈtɒpɪk]	n.  主题； 话题，论题； 标题，细目；	
torch	[tɔ:tʃ]	n.  火把，火炬； 手电筒；	vt.& vi.  放火烧，纵火烧（建筑物或汽车）；	
torture	[ˈtɔ:tʃə(r)]	n.  拷问； 折磨； 痛苦； （精神上或肉体上的）折磨	vt.  使痛苦； 使苦恼； 使焦急； 曲解	
tough	[tʌf]	adj.  坚强的，坚韧的，不屈不挠的； 艰苦的，困难的，难办的； 牢固的，强壮的； 粗暴的	n.  粗暴的人； 暴徒，恶棍；	vt.  忍耐，忍受（常与out连用）；	adv.  强硬地，顽强地； 以强硬的态度；	
tour	[tʊə(r)]	n.  旅行，观光； 巡回演出； 任职期； 轮班	vt.  到…旅游； 在…巡回演出；	vi.  观光； 巡回；	
towel	[ˈtaʊəl]	n.  毛巾，手巾； 纸巾；	vt.  用毛巾擦；	vi.  用毛巾擦干身体；	
trace	[treɪs]	vt.  跟踪，追踪； 追溯，探索； 探索； 查找	vi.  沿着一小径或道路前进； 可以追溯的；	n.  痕迹，踪迹； 微量，极少量； [植]（脉）迹； 痕迹	
tractor	[ˈtræktə(r)]	n.  拖拉机； 牵引器；	
tradition	[trəˈdɪʃn]	n.  传统； 惯例； [宗]经外传说； [法]移交，引渡	
tragedy	[ˈtrædʒədi]	n.  悲剧，惨剧； 悲剧文学； 悲剧理论，悲剧表演艺术； 悲剧式作品	
trail	[treɪl]	vt.  跟踪，追踪； 拖曳：让…拖或飘扬在后面； 拖沓而行； 跟在…后面	vi.  （在比赛等中）输； （尤指跟在他人后面）疲惫地走； （在比赛或其他竞赛中）落后； 蔓生	n.  足迹； 臭迹； 小径； 一缕	
transfer	[trænsˈfɜ:(r)]	vt.  使转移； 使调动； 转让（权利等）； 让与	vi.  转让； 转学； 转乘； 转会（尤指职业足球队）	n.  转移； 调动； 换乘； （运动员）转会	
transform	[trænsˈfɔ:m]	vt.  改变； 改观； 变换；	vi.  改变；	n.  [数]变换式；	
translation	[trænsˈleɪʃn]	n.  翻译； 译本； 转变； 转化	
transmission	[trænsˈmɪʃn]	n.  播送； 传送； （电台或电视）信息； 传动装置	
transmit	[trænsˈmɪt]	vt.  传输； 传送，传递； 发射； 传染	vi.  发送信号；	
transparent	[trænsˈpærənt]	adj.  透明的； 清澈的； 易识破的； 显而易见的	
transport	[ˈtrænspɔ:t]	vt.  运送，运输； 流放； 使欣喜若狂；	n.  运输； 运输船（机），运输系统； 狂喜； 流放犯	
transportation	[ˌtrænspɔ:ˈteɪʃn]	n.  运送，运输； 运输系统； 运输工具； 流放	
trap	[træp]	vt.  诱骗； 使受限制； 困住； 使（水与气体等）分离	n.  圈套； （对付人的）计谋； （练习射击用的）抛靶器； （捕捉动物的）夹子	vi.  设陷阱； 装捕捉机； 设圈套；	
trash	[træʃ]	n.  垃圾，废物； 断枝，碎块； 废话； 社会渣滓	vt.  废弃； 拆毁； 搞垮，贬低； 从…上除去细枝或枝条	
tray	[treɪ]	n.  盘子； 托盘； 浅盘； 满盘	
treatment	[ˈtri:tmənt]	n.  治疗，疗法； 处理； 待遇，对待；	
treaty	[ˈtri:ti]	n.  条约； 协议，协商； 谈判；	
tremble	[ˈtrembl]	vi.  发抖； 焦虑； 颤动； 轻轻摇晃	n.  震颤，发抖； 颤动，震动； 摇晃； 战栗	vt.  使挥动； 用颤抖的声音说出； 颤动，震动； 焦虑，担忧	
wrist	[rɪst]	n.  腕，手腕； 腕关节； （衣袖等的）腕部；	
writer	[ˈraɪtə(r)]	n.  作家； 作者； 撰写人； 写字…的人	
writing	[ˈraɪtɪŋ]	n.  文字； 写作； 文章； 笔迹	v.  写（ write的现在分词）； 写信；	
X-ray	[ˈeksrei]	n.  X光照片；	vt.  照X光；	
yawn	[jɔ:n]	vi.  打呵欠； 张开，裂开； 张开大口；	n.  呵欠； 无聊的人或事； 裂口；	
yearly	[ˈjɪəli]	adj.  每年的，一年一度的； 一年间的；	adv.  每年，一年一度； 在那一年间；	n.  年利； 年鉴；	
yield	[ji:ld]	vt.  屈服，投降； 生产； 获利； 不再反对	vi.  放弃，屈服； 生利； 退让，退位；	n.  产量，产额； 投资的收益； 屈服，击穿； 产品	
youngster	[ˈjʌŋstə(r)]	n.  年轻人； 小孩子； 少年；	
zone	[zəʊn]	n.  地带； 区域，范围； 地区，时区； [物]晶带	vt.  划分成带； 用带子围绕；	vi.  分成区，分成地带；	
abundance	[əˈbʌndəns]	n.  丰富，充裕； 大量，极多； 盈余； 丰度	
accommodate	[əˈkɒmədeɪt]	v.  容纳； 适应； 向…提供住处； 考虑到	
aerial	[ˈeəriəl]	adj.  空气的； 航空的，空中的； 空想的；	n.  [电讯] 天线；	
aisle	[aɪl]	n.  过道，通道； 侧廊，耳堂； 狭长的通路；	
ambitious	[æmˈbɪʃəs]	adj.  有雄心的； 有野心的； 费力的； 耗资的	
applaud	[əˈplɔ:d]	vt.  鼓掌欢迎，欢呼； 称赞，赞许； 赞成，同意；	vi.  夸赞，鼓掌；	
appraisal	[əˈpreɪzl]	n.  评价，估量； 鉴定，估价（尤指估价财产，以便征税）；	
auction	[ˈɔ:kʃn]	n.  拍卖； 竞卖； 标售； （桥牌）拍卖玩法	vt.  拍卖； 竞卖；	
aviation	[ˌeɪviˈeɪʃn]	n.  航空； 飞行术，航空学； 飞机制造业； [集合词]飞机	
bachelor	None	None	
baffle	[ˈbæfl]	vt.  使受挫折； 使困惑，使迷惑； 用隔音板隔音； 挡住（水流等）	n.  隔板，挡板； 迷惑； 遮护物，阻碍体； [军]迷彩	
ballet	[ˈbæleɪ]	n.  芭蕾舞； 芭蕾舞剧； 芭蕾舞团； 芭蕾舞音乐	
beforehand	[bɪˈfɔ:hænd]	adv.  事先，预先； 提前；	adj.  提前的； 预先准备好的；	
breakthrough	[ˈbreɪkθru:]	n.  突破； 穿透； 重要技术成就； 炉衬烧穿	
briefcase	[ˈbri:fkeɪs]	n.  公文包； 手提包； 公事包； 手提箱	
brutal	[ˈbru:tl]	adj.  野蛮的； 残忍的； 不讲理的； 无情的	
calorie	[ˈkæləri]	n.  大卡； 千卡（食物所产生的能量单位）； 卡路里； 卡（热量单位）	
casualty	[ˈkæʒuəlti]	n.  伤亡（人数）； 事故，横祸； 受害者，死伤者； 损坏	
census	[ˈsensəs]	n.  人口普查，统计； 人口财产调查；	
cling	[klɪŋ]	vi.  附着于，紧贴； 抓紧或抱住； 坚持； 沿（岸）前进，贴着（墙）走	vt.  依恋，依附于；	
cognitive	[ˈkɒgnətɪv]	adj.  认知的； 认识的；	
commonplace	[ˈkɒmənpleɪs]	adj.  平凡的，陈腐的； 平庸的，普通的；	n.  寻常的事物； 平常话，口头禅； 老生常谈； 备忘录	
compensate	[ˈkɒmpenseɪt]	vt.  补偿，赔偿； 报酬； 抵消；	vi.  补偿，弥补；	
concise	None	None	
conform	[kənˈfɔ:m]	vi.  符合； 遵照； 适应环境；	vt.  使遵守； 使一致； 使顺从；	adj.  一致的； 顺从的；	
consequent	[ˈkɒnsɪkwənt]	adj.  随之发生的； 必然的，合乎逻辑的； 继起的； [地]顺向的	n.  结果； [逻]后件，结论； [数]后项； [语]（条件结构中的）结果子句	
console	[kən'səʊl]	vt.  安慰，慰问；	n.  （机器的）操纵台，仪表板；	
continuity	[ˌkɒntɪˈnju:əti]	n.  连续性，继续； 分镜头电影剧本； 串联，衔接； [影视]剪辑	
cooperative	[kəʊ'ɒpərətɪv]	adj.  合作的； 协助的； 共同的； 〈美〉（大学文科）有关[包含]各种实习活动的	n.  合作社，联合体；	
corporate	[ˈkɔ:pərət]	adj.  法人的，团体的，社团的； 公司的，总体国家的； 〈古〉团结的； 共同的，全体的	
costume	[ˈkɒstju:m]	n.  （戏剧或电影的）戏装，演出服； 服装，衣服； 泳装，常用于英式英语； （某地或某历史时期的）服装	vt.  给…穿上服装； 给…提供服装；	
courtesy	[ˈkɜ:təsi]	n.  谦恭有礼，礼貌，请安； 有礼貌的举止[言词]； 承蒙；	adj.  殷勤的； 出于礼节的；	
coverage	[ˈkʌvərɪdʒ]	n.  范围，规模； 保险项目； （新闻）报道； [植]优势度	
creation	[kriˈeɪʃn]	n.  制造，创造； 创造物，产物； （尤指所述由上帝）创造天地，宇宙； （爵位等的）封授	
cumulative	[ˈkju:mjələtɪv]	adj.  累积的； 渐增的； 追加的； （判刑等）加重的	
deadly	[ˈdedli]	adj.  极端的，非常的； 致命的，致死的； 非常有效的； 如死一般的	adv.  极其，非常； 死了一样地；	
decisive	[dɪˈsaɪsɪv]	adj.  决定性的； 坚定的； 果断的，决断的；	
defiance	[dɪˈfaɪəns]	n.  蔑视； 挑战； 反抗；	
deficiency	[dɪˈfɪʃnsi]	n.  缺乏，不足； 缺点，缺陷； 不足额；	
destructive	[dɪˈstrʌktɪv]	adj.  破坏性的； 毁灭性的； 有害的；	
diligent	[ˈdɪlɪdʒənt]	adj.  勤奋的； 勤勉的； 用功的； 费尽心血的	
disastrous	[dɪˈzɑ:strəs]	adj.  灾难性的； 损失惨重的； 极坏的； 悲惨的	
divine	[dɪˈvaɪn]	adj.  神的， 天赐的； 极好的； 神圣的；	vt.&vi.  占卜，预言； 猜测， 预测； （用丫形杖）探测（地下水）；	n.  牧师； 神学家；	
dock	[dɒk]	n.  码头； 被告席； 草本植物； 尾巴的骨肉部份	vt.& vi.  （使）船停靠码头； 剪短（尾巴等）； 削减，缩减（工资等）； 在…设置船坞	vi.  入船坞；	
endurance	[ɪnˈdjʊərəns]	n.  耐久（力），持久（力）； 忍耐，忍耐力；	
energetic	[ˌenəˈdʒetɪk]	adj.  精力充沛的，充满活力的； 精力旺盛的，精神饱满的； （措施等）积极的，有力的； 雄健	
enrich	[ɪnˈrɪtʃ]	vt.  使富裕，使富有； 给…添加肥料； 使…美味； 装饰	
enthusiastic	[ɪnˌθju:ziˈæstɪk]	adj.  热心的； 热情的； 热烈的； 狂热的	
erosion	[ɪ'rəʊʒn]	n.  腐蚀，侵蚀，磨损； 烧蚀； 磨蚀； 糜烂	
eternal	[ɪˈtɜ:nl]	adj.  永恒的，永久的； 似乎不停的，没完没了的； 不朽的； 永生的	n.  永恒的事物； Eternal 上帝，与定冠词the 连用；	
ethnic	[ˈeθnɪk]	adj.  种族的，部落的； 某文化群体的；	n.  少数民族的成员；	
expedition	[ˌekspəˈdɪʃn]	n.  考察，远航； 考察队，远征军； （短途的）旅行； 迅速（办理）	
fake	[feɪk]	vt.  伪造； 篡改； 对…做手脚； 仿造	vt.& vi.  假装；	n.  骗子； 冒牌货，赝品； [体]假动作； 冒充，诈骗	adj.  假的，冒充的；	
fitting	None	None	
flaw	[flɔ:]	n.  瑕疵，缺点； 一阵狂风； 短暂的风暴； 裂缝，裂纹	v.  使生裂缝，使有裂纹； 使无效； 使有缺陷；	vi.  生裂缝； 变的有缺陷；	
foster	[ˈfɒstə(r)]	v.  培养； 抚育； 促进； 代养	adj.  寄养的； 代养的；	
grim	[grɪm]	adj.  冷酷的，残忍的； 严厉的； 阴冷的； 可怕的，讨厌的	
heighten	[ˈhaɪtn]	vt.& vi.  （使）变高； （使）加强；	
heir	[eə(r)]	n.  继承人； 后嗣，嗣子；	
heritage	[ˈherɪtɪdʒ]	n.  遗产； 继承物； 传统； 文化遗产	
hum	[hʌm]	vt.  哼唱；	vi.  忙碌，活跃； 发嗡嗡声； 发出嘈杂声；	n.  嗡嗡声； 杂音； 哼唱的动作；	int.  哼； 嗯；	
humanity	None	None	
hurricane	[ˈhʌrɪkən]	n.  飓风，十二级风； 飓风般猛烈的东西； （感情等的）爆发； 飓风式战斗驱逐机	
identification	[aɪˌdentɪfɪˈkeɪʃn]	n.  鉴定，识别； 验明； 身份证明； 认同	
illusion	[ɪˈlu:ʒn]	n.  错觉； 幻想； 错误观念； 假象	
imaginative	[ɪˈmædʒɪnətɪv]	adj.  富于想像力的，运用想像力的； 想象或创造出来的； 沉溺于想象的； 虚假的	
imitation	[ˌɪmɪˈteɪʃn]	n.  模仿，仿效； 仿制品； 赝品； [生]拟态	adj.  人造的； 仿制的；	
imperative	[ɪmˈperətɪv]	adj.  必要的，不可避免的； 命令的，专横的； 势在必行的； [语]祈使的	n.  必要的事； 命令； 规则； [语]祈使语气	
indicative	[ɪnˈdɪkətɪv]	adj.  象征的； 指示的，表示的； [语]陈述的，直陈的；	n.  [语]陈述语气；	
induce	[ɪnˈdju:s]	vt.  引诱； 引起； [电]感应； 归纳	
inland	[ˌɪnˈlænd]	adj.  内地的，内陆的； 国内的；	adv.  向内地，在内地； 向内陆，在内陆；	n.  内地，内陆； 国内；	
instrumental	[ˌɪnstrəˈmentl]	adj.  乐器的； 仪器的； 有帮助的； 起作用的	
assign	[əˈsaɪn]	vt.  分派，选派，分配； 归于，归属； [法律] 把（财产，权利、利息）从一人转让给另一人； 把…编制	n.  [常用复数][法律]受让人，接受财产等转让的人，受托者；	
assignment	[əˈsaɪnmənt]	n.  分给，分配； 任务，工作，（课外）作业； 任命； 指定，委派	
assist	[əˈsɪst]	n.  帮助； 援助； 机器助手； 辅助装置	vt.  帮助； 援助； 帮助某人做某事； 搀扶（某人）上下车	vi.  援助； 出席； 参加；	
assistance	[əˈsɪstəns]	n.  帮助，援助； 〈古〉出席，出席者； 辅助设备；	
assistant	[əˈsɪstənt]	n.  助手，助理； [化学]（染色的）助剂； 辅助物； 店员，伙计	adj.  助理的； 辅助的； 有帮助的； 副的	
associate	[əˈsəʊʃieɪt]	vt.  （使）发生联系； （使）联合； 结交； 联想	vi.  联盟； 陪伴同事；	adj.  非正式的；准的；副的，联合的；有关联的；	n.  同事；伙伴，合伙人，准学士（获得两年制高校学位）；	
association	[əˌsəʊʃiˈeɪʃn]	n.  协会，社团； 联合，联系； 联想；	
assume	[əˈsju:m]	v.  假定，认为； 承担； 装出； 呈现	
assumption	[əˈsʌmpʃn]	n.  假定，假设； 承担； 想当然； 采取	
assure	[əˈʃʊə(r)]	vt.  向…保证； 使…确信； 给…保险；	
astonish	[əˈstɒnɪʃ]	vt.  使惊讶，使大为吃惊；	
athlete	[ˈæθli:t]	n.  运动员； 体育家； 强壮的人；	
atmosphere	[ˈætməsfɪə(r)]	n.  大气，空气； 大气层； 风格，基调； 气氛	
atomic	[əˈtɒmɪk]	adj.  原子的； 原子能的，原子武器的； 极微的；	
attach	None	None	
attack	[əˈtæk]	vt.& vi.  攻击，进攻，抨击；	n.  攻击； 抨击； （队员等的）进攻； （疾病）侵袭	vt.  抨击； 非难； 侵袭； 损害	
attain	[əˈteɪn]	vt.& vi.  达到，获得； 遂愿； 经过努力到达某事物；	vt.  达到，实现； 获得； 到达；	vi.  达到； 获得； 到达；	
attempt	[əˈtempt]	vt.  试图； 尝试；	n.  进攻； 尝试，冲击；	
attitude	[ˈætɪtju:d]	n.  态度； 看法； 姿势； 个人风格	
attorney	[əˈtɜ:ni]	n.  代理人； 律师；	
attract	None	None	
attraction	[əˈtrækʃn]	n.  吸引； [物]引力； 魅力； 引人注意的东西，有趣的东西	
attractive	[əˈtræktɪv]	adj.  有魅力的； 引人注目的； 迷人的； 招人喜爱的	
attribute	[əˈtrɪbju:t]	vt.  认为…是； 把…归于； 把…品质归于某人； 认为某事[物]属于某人[物]	
audience	[ˈɔ:diəns]	n.  观众，听众，读者； 读者； 接见； 拥护者，爱好者	
audio	[ˈɔ:diəʊ]	adj.  听觉的，声音的； 音频的；	n.  声音回路； 音响； 可听到的声音； 声音信号	
author	[ˈɔ:θə(r)]	n.  著作家； 作者； 创造者； 发起人	vt.  创作出版；	
authority	[ɔ:ˈθɒrəti]	n.  权威； 权力； 学术权威； [复数]当权者	
auto	[ˈɔ:təʊ]	n.  汽车； 自动；	
automatic	[ˌɔ:təˈmætɪk]	adj.  自动的； 不假思索的，无意识的； 必然发生的；	n.  自动化机器或设备； 自动手枪；	
automobile	[ˈɔ:təməbi:l]	n.  汽车；	v.  开汽车，坐汽车；	
auxiliary	[ɔ:gˈzɪliəri]	adj.  辅助的； 备用的，补充的； 附加的； 副的	n.  助动词； 辅助者，辅助人员； 附属机构，附属团体； 辅助设备	
available	[əˈveɪləbl]	adj.  可获得的； 有空的； 可购得的； 能找到的	
avenue	[ˈævənju:]	n.  林荫路； 大街； 途径，手段； 〈美〉（南北向）街道	
average	[ˈævərɪdʒ]	adj.  平常的； 平均的； 典型的； （价值、比率等的）平均数的	n.  平均水平； （速度等的）平均率； 平均估价；	vt.  [数学] 计算…的平均值； 调和，拉平； 分摊； 按比例（或平均）分配（利润等）	vi.  平均：作为或达到一个中间值； 维持（有利的）平均价格；	
avoid	[əˈvɔɪd]	vt.  避开，避免，预防； [法]使无效，撤销，废止；	
await	[əˈweɪt]	vt.  等候； 等待； 期待；	
award	[əˈwɔ:d]	vt.  授予，奖给，判给； 判归，判定；	n.  奖品； （仲裁人、公断人的）裁定； （法院、法官的）判决； 裁定书	
aware	[əˈweə(r)]	adj.  意识到的； 知道的； 觉察到的；	
awful	[ˈɔ:fl]	adj.  糟糕的； 可怕的； 非常的； 极坏的	adv.  非常，极；	
awkward	[ˈɔ:kwəd]	adj.  令人尴尬的； 难对付的； 不方便的； 笨拙的	
ax	[æks]	n.  斧头；	v.  削减； 解雇；	
background	[ˈbækgraʊnd]	n.  （画等的）背景； 底色； 背景资料； 配乐	
backward	[ˈbækwəd]	adj.  向后的； 反向的； 怯生生的； 落后的	adv.  向后地； 相反地； 回溯地；	
bacon	[ˈbeɪkən]	n.  培根； 熏猪肉； 咸猪肉； 腊肉	
bacteria	[bækˈtɪəriə]	n.  细菌(bacterium的名词复数)；	
baggage	[ˈbægɪdʒ]	n.  行李； 辎重； 精神包袱； 荡妇	
bake	[beɪk]	vt.  烤，烘焙； （将某物）烤硬； （变得）灼热，炎热；	vi.  烤，烘； 烘干；	n.  烤，烘焙； 烘烤食品； 烧烤会餐；	
balance	[ˈbæləns]	n.  平衡； 天平； 平衡力； （酿酒配料的）均衡	vt.& vi.  （使）平衡； （使）均衡； （使）相抵； 权衡	vt.  结平（账目）； 使（在某物上）保持平衡； 使（各部分）协调； 用天平称	vi.  微微摇摆； 倾斜后又复平衡； 动摇； 被补偿	
balcony	[ˈbælkəni]	n.  阳台； （电影院等的）楼厅，楼座； 包厢；	
balloon	[bəˈlu:n]	n.  气球； 热气球； [建]球饰；	vt.  膨胀，涨大； 乘热气球飞行； 使激增；	adj.  气球状的； （货物等）分量轻而体积大的； （分期付款）最后一笔大数目的；	vi.  乘气球飞行； 膨胀； 激增；	
ban	[bæn]	vt.  禁止，下令禁止； 剥夺权利； [古]诅咒；	n.  禁止，禁令； 谴责； 诅咒，诅骂； 革出教门	
band	[bænd]	n.  带； 乐队； 衣带； 价值	vt.  给…镶边； 用带绑扎； （将价格、收入等）划分档次； 把…联合起来	vt.& vi.  结合起来，伙同；	vi.  聚集，联合（起来）（通常与together 连用）；	
bang	[bæŋ]	n.  猛击； 猛撞； 巨响； 爆炸声	vt.  猛击，猛撞；	vi.  发出砰的一声，砰砰作响，砰地敲[推，扔]； 男性和（女性）性交；	adv.  正好，完全地；	
bankrupt	None	None	
banner	[ˈbænə(r)]	n.  横幅； 旗，旗帜； 标语； 大字标题	adj.  第一流的，第一位的； 杰出的； 领先的，为首的； 突出地支持（某一政党）的	
barber	[ˈbɑ:bə(r)]	n.  理发师； 理发店(= barber's shop)；	vt.  为…理发剃须； 修整；	vi.  当理发师； 给人理发；	
bare	[beə(r)]	adj.  光秃秃的； （房间、柜子等）空的； 赤裸的； 刚好够的	vt.  使赤裸； 使露出； 揭开； 脱（衣服）	
barely	[ˈbeəli]	adv.  仅仅，勉强，好不容易才； 几乎不，几乎没有； 赤裸裸地，无遮蔽地； 公然地，露骨地，公开地	
bargain	[ˈbɑ:gən]	n.  契约，协定； 交易； 特价商品； 便宜货	vt.  做交易；	vi.  讨价还价； 达成协议；	
bark	[bɑ:k]	vi.  吠叫； 厉声说话；	vt.  大声喊出； 厉声说出；	n.  犬吠声； 似吠声； 树皮；	
barn	[bɑ:n]	n.  谷仓，粮仓； 牲口棚； （公共汽车、卡车等的）车库； 一种特别大且空荡的房屋	
barrel	[ˈbærəl]	n.  桶； 一桶之量； 圆筒，活塞筒，滚筒； 圆筒	adj.  桶状的；	vt.  装进桶里，放进桶里；	vi.  高速行驶；	
barrier	[ˈbæriə(r)]	n.  障碍； 屏障； 栅栏； 分界线	vt.  把…关入栅栏； 用栅栏围住；	
baseball	[ˈbeɪsbɔ:l]	n.  棒球； [体]棒球运动；	
basically	[ˈbeɪsɪkli]	adv.  主要地； 从根本上说； 基本，基本上； 总的说来	
basis	[ˈbeɪsɪs]	n.  基础； 主要成分； 基准，基本原则；	
bat	[bæt]	n.  蝙蝠； 短棍，（棒球等的）球棒，（网球等的）球拍； 白话，口语，成语，俗话； （口）打击，猛击，（海上）导弹	vt.& vi.  用球板击球，用球棒击球（尤指板球或棒球运动）；	
bathe	[beɪð]	vt.& vi.  给…洗澡，游泳； 把…浸泡在液体中； （用海绵等）洗； 把…弄湿，润湿	vt.  冲洗； 浸； 用水清洗（尤指身体部位）； （以光线）撒满	n.  游泳； （在河，海中的）游泳；	
battery	[ˈbætri]	n.  [电]电池，蓄电池； [军]炮台，炮位； 一组； [法]殴打	
bay	[beɪ]	n.  湾，海湾； 犬吠声； 月桂树； 吊窗，凸窗	vi.  （尤指猎犬等）吠，叫，咆哮； 筑堤遏（水）； 穷追，使陷入绝境； 阻止（敌人）不使前进	adj.  赤褐色的，栗色的；	vt.  向…吠叫；	
beam	[bi:m]	n.  梁，栋梁； 束； 光线； （电波的）波束	vi.  发出光与热； 面露喜色；	vt.  播送； 以梁支撑； 用…照射； 流露	vt.& vi.  笑容满面，眉开眼笑； 发射电波，播送； 放出束状的光（或热）；	
bean	[bi:n]	n.  豆； 豆形种子； 毫无价值的东西；	vt.  将（球）击中击球员头部；	int.  胡说！呸！不可能！；	
beard	[bɪəd]	n.  胡须； [虫]口鬃，[动]颌毛； （牡蛎等的）鳃； [植]芒	vt.  使有胡须（颌毛，芒刺）； 抓（捋）住…的胡子，拔…的胡子； 公然反对，勇敢地对抗；	
bearing	[ˈbeərɪŋ]	n.  [机]轴承，支座； 关系； 方位； 态度，举止	v.  忍受(bear的ing形式)；	
beast	[bi:st]	n.  野兽； 人面兽心的人； 讨厌的人（或事物）； 老顽固，坏蛋	
beggar	[ˈbegə(r)]	n.  乞丐； 家伙；	vt.  使贫困； 使无用；	
behalf	[bɪˈhɑ:f]	n.  利益； 维护； 支持；	
behave	[bɪˈheɪv]	vi.  表现； 举止端正； 自然反应；	vt.  使守规矩；	
behavior	[bɪ'heɪvjə]	n.  行为； 态度； （机器等的）运转状态； （事物的）反应	
being	[ˈbi:ɪŋ]	n.  存在； 生物； 人； 要素，本质	
clerk	[klɑ:k]	n.  店员； 办事员，职员； 书记员； 牧师，教士	vi.  当职员； 当销售员；	
click	[klɪk]	n.  喀哒声； 点击；	v.  使发出咔嗒声； 点击； 突然明白； 合得来	
client	[ˈklaɪənt]	n.  顾客； 当事人； 诉讼委托人； [计算机]客户端	
cliff	[klɪf]	n.  悬崖，峭壁；	
climate	[ˈklaɪmət]	n.  气候； 氛围； 状况； 局势	
clue	[klu:]	n.  线索； 提示； （帮助警方破案的）线索； （纵横填字谜、游戏或问题的）提示词语	vt.  为…提供最新情况（消息等）；	
clumsy	[ˈklʌmzi]	adj.  笨拙的； 复杂难懂的； 得罪人的； （文体等）臃肿的	
coach	[kəʊtʃ]	n.  教练； （铁路）旅客车厢； 长途客运汽车； 四轮大马车	vt.& vi.  训练； 辅导；	vt.  训练； 指导；	vi.  作指导； 受训练[辅导]； 坐马车旅行；	
coarse	[kɔ:s]	adj.  粗鄙的； 粗糙的； 粗野的； 粗制滥造的	
coil	[kɔɪl]	n.  （一）卷，（一）盘； 盘卷之物； 线圈； 纷乱，纠缠不清	vt.  盘绕； 卷成一圈；	vi.  绕成盘状； 卷绕成圈；	
collapse	[kəˈlæps]	vi.  折叠； 倒塌； 崩溃； （尤指工作劳累后）坐下	vt.  使倒塌； 使坍塌； 使瓦解；	n.  垮台； （身体的）衰弱；	
colleague	[ˈkɒli:g]	n.  同事； 同僚； 同行；	
collection	[kəˈlekʃn]	n.  收集，采集； 征收； 收藏品； 募捐	
collective	[kəˈlektɪv]	adj.  集体的； 共同的； 集合的； 集体主义的	n.  [统]集体； [语]集合名词； 集团；	
collision	None	None	
colony	[ˈkɒləni]	n.  殖民地； 聚居地； 群体； 聚居人群	
column	[ˈkɒləm]	n.  纵队，列； 圆柱； 专栏；	
comb	[kəʊm]	n.  梳子； 梳棉机； 鸡冠状的东西； 蜂窝状的东西	vt.  梳理； 彻底搜查；	vi.  涌起，卷起；	
combat	[ˈkɒmbæt]	n.  格斗，搏斗，战斗； 〈美〉竞赛，比赛； 论战；	vt.  与…战斗； 与…斗争； 防止； 减轻	
combination	[ˌkɒmbɪˈneɪʃn]	n.  结合； 联合体； 密码组合； 连裤内衣	
combine	[kəmˈbaɪn]	v.  使结合； 使化合； 兼有； 用联合收割机收割	
comedy	[ˈkɒmədi]	n.  喜剧； 喜剧性； 喜剧体裁； 有趣的事情	
command	[kəˈmɑ:nd]	n.  命令，指挥； 司令部，指挥部； [计算机]指令； 控制力	vt.  指挥，控制，命令； 命令； 应得，值得；	vi.  给出命令； 命令，指令；	adj.  指挥的，根据命令（或要求）而作的；	
commander	[kəˈmɑ:ndə(r)]	n.  指挥官，司令官； [海]中校，副舰长； 木槌；	
comment	[ˈkɒment]	n.  评论； 解释； 批评； 指责	v.  表达意见； 作出评论；	
commerce	None	None	
commercial	[kəˈmɜ:ʃl]	adj.  商业的； 贸易的； 营利的； 靠广告收入的	n.  （电台或电视播放的）广告；	
commission	[kəˈmɪʃn]	n.  委员会，委员； [商]佣金，手续费； 任命，委任； 委任状	vt.  委任，授予； 使服役； 使（船）服役；	
commit	[kəˈmɪt]	vt.  犯罪，做错事； 把…托付给； 保证（做某事、遵守协议或遵从安排等）； 承诺，使…承担义务	
commitment	[kəˈmɪtmənt]	n.  承诺，许诺； 委任，委托； 致力，献身； 承担义务	
committee	[kəˈmɪti]	n.  委员会；	
communicate	[kəˈmju:nɪkeɪt]	vt.  传达，表达； 显示：清晰地揭示； 表明； 传染：扩散	vi.  通讯； 交际； 相连； 相通	
communication	[kəˌmju:nɪˈkeɪʃn]	n.  通讯，通信； 交流； 书信； 传达	
community	[kəˈmju:nəti]	n.  社区； 社会团体； 共同体； [生态] 群落	
companion	[kəmˈpæniən]	n.  同伴； [天]伴星(=~star)； （用于书名）指南； 同甘共苦的伙伴	vt.  同行； 陪伴；	
comparable	[ˈkɒmpərəbl]	adj.  可比较的； 比得上的；	
comparative	[kəmˈpærətɪv]	adj.  比较（上）的； 按比较估计的； 相当的，还可以的；	n.  [语]（形容词或副词的）比较级形式； 可匹敌者，可比拟物；	
compare	[kəmˈpeə(r)]	vt.& vi.  比较，对照；	vt.  比拟，喻为； [语]构成；	vi.  相比，匹敌； 比较，区别； 比拟（常与to连用）；	n.  比较；	
comparison	[kəmˈpærɪsn]	n.  比较，对照； [语]比喻； 比较级；	
compass	[ˈkʌmpəs]	n.  罗盘； 指南针； 圆规； 界限	
compel	[kəmˈpel]	vt.  强迫，迫使； 强制发生，使不得不；	
compete	[kəmˈpi:t]	vi.  竞赛； 竞争； 比得上； 参加比赛（或竞赛）	
competent	[ˈkɒmpɪtənt]	adj.  有能力的，能胜任的； 能干的，称职的； 足够的，充足的； 有决定权的	
competition	[ˌkɒmpəˈtɪʃn]	n.  竞争； 比赛； 竞争者； [生]生存竞争	
competitive	[kəmˈpetətɪv]	adj.  竞争的，比赛的； （价格等）有竞争力的； （指人）好竞争的； [生化] 抑制酶作用的	
complain	[kəmˈpleɪn]	vi.  抱怨，诉苦； 申诉，控诉，抗议；	vt.  诉说，申诉，控告[后面常跟从句]；	
complaint	[kəmˈpleɪnt]	n.  抱怨，控诉； 委屈，怨言； 平平的来由； 痛苦根源	
complex	[ˈkɒmpleks]	adj.  复杂的； 难懂的； 复合的；	n.  建筑群； 相关联的一组事物； 情结； 不正常的忧虑	
complicated	[ˈkɒmplɪkeɪtɪd]	adj.  结构复杂的； 混乱的，麻烦的；	v.  使复杂化( complicate的过去式)；	
component	[kəmˈpəʊnənt]	n.  成分； 零件； [数]要素； 组分	adj.  组成的； 合成的； 构成的； 成分的	
compose	[kəmˈpəʊz]	vt.  组成，构成； 调解； [印刷]排（字）； 使安定	vt.& vi.  创作（乐曲、诗歌等）； 为…谱曲；	vi.  构图，构成；	
compound	[ˈkɒmpaʊnd]	n.  场地； 复合物； （筑有围墙的）院子； 复合词	
comprehension	[ˌkɒmprɪˈhenʃn]	n.  理解，理解力； 包含的能力； [逻辑学]内涵；	
comprehensive	[ˌkɒmprɪˈhensɪv]	adj.  广泛的； 综合的； 有理解力的，悟性好的； [保险业]总体担保的	n.  [常用复数]专业综合考试； 综合学校； 综合性中学；	
compress	[kəmˈpres]	vt.  压紧； 压缩； 精简；	n.  止血敷布； 打包机；	
comprise	[kəmˈpraɪz]	vt.  包含，包括； 由…组成； 由…构成；	
compromise	[ˈkɒmprəmaɪz]	n.  妥协； （名誉等的）损害； 妥协（或折中）方案； 折中物	vi.  折中解决； 妥协，退让；	vt.  违背（原则）； 连累； （尤指因行为不很明智）使陷入危险；	
conceal	[kənˈsi:l]	vt.  隐藏，隐瞒，遮住；	
concede	[kənˈsi:d]	v.  承认； 让步，容许； 承让；	
concentrate	[ˈkɒnsntreɪt]	vt.& vi.  专心于； 注意； 集中； 聚集	vt.  浓缩，（使）浓缩； [采矿]汰选； 选矿，精选，富集；	vi.  凝缩，浓缩，提纯；	n.  浓缩物；	adj.  集中起来的，经过浓缩的；	
concentration	[ˌkɒnsnˈtreɪʃn]	n.  集中； 专心； 关注； 浓度	
concept	[ˈkɒnsept]	n.  观念，概念； 观点； 思想，设想，想法； 总的印象	
concern	[kənˈsɜ:n]	vt.  涉及，关系到； 使关心，使担忧； 参与；	n.  关心； 关系，有关； 顾虑； 公司或企业	
concerning	[kənˈsɜ:nɪŋ]	prep.  （表示论及）关于，就…而论；	v.  “concern”的现在分词； 涉及； 关心； 顾虑，忧虑	
concession	[kənˈseʃn]	n.  让步，迁就； （尤指由政府或雇主给予的）特许权； 租借地； 承认或允许	
conclude	[kənˈklu:d]	vt.& vi.  结束，终止； 推断； 议定；	vt.  得出结论； 缔结； 推断出； 决定	vi.  终了； 作出决定或达成协议；	
conclusion	[kənˈklu:ʒn]	n.  结论； 结局； 断定，决定； 推论	
concrete	[ˈkɒŋkri:t]	adj.  具体的，有形的，实在的，实际的； 固结成的，混凝土制的； 图案诗歌的；	n.  混凝土； 具体物； （图案式）有形诗； 〔建〕钢筋混凝土	vt.  使凝固； 用混凝土修筑； 萃取；	vi.  凝固； 固结； 变坚固； 使用混凝土	
condemn	[kənˈdem]	vt.  （通常因道义上的原因而）谴责； 宣判； 宣布…不能使用； 迫使…陷于不幸的境地	
condense	[kənˈdens]	v.  （使）冷凝； （使）凝结； 精简； 压缩	
condition	[kənˈdɪʃn]	n.  状态； 环境； 健康状况； 条款	vt.  制约； 限制； 使习惯于； 使适应	vt.& vi.  对…具有重要影响； 影响（某事发生的方式）； 保持（头发或皮肤等的）健康； 养护	
conduct	[kənˈdʌkt]	v.  组织； 实施； 执行； 指挥 传导（热或电）；	n.  （人在某地或某种情况下的）行为，举止，经营方式；管理方法；实施办法；	
conductor	[kənˈdʌktə(r)]	n.  导体； 售票员； （乐队）指挥； 导管（套管的一种）	
conference	[ˈkɒnfərəns]	n.  会议； 讨论； （正式）讨论会； [工会、工党用语]（每年的）大会	vi.  举行或参加（系列）会议；	
confess	[kənˈfes]	v.  供认； 坦白； 承认； 悔过	
confidence	[ˈkɒnfɪdəns]	n.  信心； 信任； 秘密；	adj.  骗得信任的； 欺诈的；	
confident	[ˈkɒnfɪdənt]	adj.  确信的，深信的； 有信心的，沉着的； 大胆的，过分自信的； 厚颜无耻的	n.  知己； 心腹朋友；	
confine	[kənˈfaɪn]	vt.  限制； 局限于； 禁闭； 管制	n.  界限，范围； 国界；	
confirm	[kənˈfɜ:m]	vt.  [法]确认，批准； 证实； 使有效； 使巩固	
conflict	[ˈkɒnflɪkt]	n.  冲突； 战斗； 相互干扰； 矛盾	vi.  抵触； 争斗； 战斗； 冲突	
confront	None	None	
dependent	[dɪˈpendənt]	adj.  依靠的； 依赖的； 取决于…的； 有瘾的	n.  受抚养人； 受赡养者； 依赖他人者； 扈从，侍从	
deposit	[dɪˈpɒzɪt]	n.  储蓄，存款； 保证金； 沉淀物； 寄存，寄存品	vt.&vi.  储蓄； 寄存； 放置，安置； 付保证金	vi.  沉淀；	
depress	[dɪˈpres]	vt.  压下，压低； 使沮丧； 使萧条； 使跌价	
depression	[dɪˈpreʃn]	n.  萎靡不振，沮丧； 下陷处，坑； 衰弱； 减缓	
deputy	[ˈdepjuti]	n.  副手； 代理人； 代表；	adj.  副的； 代理的；	
derive	[dɪˈraɪv]	vt.& vi.  得到，导出； 源于，来自； （从…中）提取；	
descend	[dɪˈsend]	v.  下来，下降 ； 下斜； 降临； 突然造访	
describe	None	None	
deserve	[dɪˈzɜ:v]	vt.  应受； 应得； 值得；	vi.  应受报答； 应得报酬； 应得赔偿； 应受惩罚	
design	None	None	
desirable	[dɪˈzaɪərəbl]	adj.  令人满意的； 值得拥有的； 可取的； 性感的	n.  称心如意的人[东西]；	
desire	[dɪˈzaɪə(r)]	vt.  希望； 渴望； 要求； 请求	n.  愿望； 欲望； 希望； 请求	vi.  有希望； 期望； 愿望； 想望	
despair	[dɪˈspeə(r)]	n.  绝望； 使人绝望的人（或事物）；	vi.  绝望；	
desperate	[ˈdespərət]	adj.  绝望的； 由绝望而引起的； 铤而走险的，孤注一掷的； 急切的，极度渴望的	
despite	[dɪˈspaɪt]	prep.  尽管； 虽然； 不由自主；	
dessert	[dɪˈzɜ:t]	n.  餐后甜食； 甜点；	
destination	[ˌdestɪˈneɪʃn]	n.  目的，目标； 目的地，终点； [罕用语]预定，指定；	
destruction	[dɪˈstrʌkʃn]	n.  破坏，毁灭，消灭，灭亡，扑灭，驱除； 摧毁； 毁灭的原因，破坏手段； 杀害	
detail	[ˈdi:teɪl]	n.  详述； （照片、绘画等的）细部； 细目，琐碎； 各种细节	vt.  详述，仔细汇报； 选派； 清晰地说明； 给于细部装饰	
detect	[dɪˈtekt]	vt.  查明，发现； 洞察； 侦察，侦查； [电子学]检波	
detection	[dɪˈtekʃn]	n.  侦查； 察觉； 发觉； 检查	
detective	[dɪˈtektɪv]	adj.  侦探的； 适于探测的； 用于探测的；	n.  侦探；	
determination	[dɪˌtɜ:mɪˈneɪʃn]	n.  决心； 决定，确定； [物]测定，计算；	
determine	[dɪˈtɜ:mɪn]	vt.& vi.  （使）下决心，（使）做出决定；	vt.  决定，确定； 判定，判决； 使决定； 限定	vi.  [主用于法律]了结，终止，结束；	
device	[dɪˈvaɪs]	n.  装置，设备； 方法； 策略； 手段	
devil	[ˈdevl]	n.  魔鬼； 家伙； 淘气鬼； 冒失鬼	vt.  虐待，折磨； （用扯碎机）扯碎； （替作家，律师等）做助手； 抹辣味料烤制或煎煮	
devise	[dɪˈvaɪz]	v.  设计； 发明； 策划； 想出	n.  遗赠； 遗赠的财产； 遗赠的条款；	
devote	[dɪˈvəʊt]	vt.  把…奉献（给），把…专用（于）； 奉献；	
diagram	[ˈdaɪəgræm]	n.  图表； 图解； 示意图； [数]线图	vt.  用图表示； 图解；	
dialect	[ˈdaɪəlekt]	n.  方言，土语； 语调； [语]语支； 专业用语	
diameter	[daɪˈæmɪtə(r)]	n.  直径，直径长； 放大率；	
dictate	[dɪkˈteɪt]	vt.  口述； 命令，指示； 使听写； 控制，支配	vi.  口述； 命令；	
dictation	[dɪkˈteɪʃn]	n.  口授，听写； 听写测验； 命令；	
differ	[ˈdɪfə(r)]	vi.  不同，相异； 不同意，意见相左； 争吵；	
digest	[daɪˈdʒest]	vt.& vi.  消化； 整理；	vt.  吸收； 领悟； 玩味；	vi.  消化； 吸收食物； [化学]加热；	n.  文摘； 摘要； 法律汇编； 罗马法典	
digital	[ˈdɪdʒɪtl]	adj.  数字的； 数据的； 手指的； 指状的	n.  手指； （钢琴等的）琴键； 数字；	
dim	[dɪm]	adj.  暗淡的，昏暗的； 不光明的； 看不清的； （性质和特征上）不显著的	vt.& vi.  （使）变暗淡； （使）变模糊； （使）减弱； 变淡漠	n.  笨蛋，傻子；	
dimension	None	None	
dip	[dɪp]	vt.  浸； （把烛芯浸在融蜡里）制造（蜡烛）； 把（汽车前灯）的远光调为近光； 洗药水浴	vt.& vi.  （使）微降，（使）下沉； （使）向下再向上；	n.  浏览； （通常指暂时的）减少； 洗澡； 倾斜	vi.  浸水； 提取； （轻度或暂时地）减少； 浏览	
diplomatic	[ˌdɪpləˈmætɪk]	adj.  外交上的； 外交人员的； 有手腕的； 策略的	
directly	[dəˈrektli]	adv.  直接地； 不久，立即； 正好地，恰好地； 坦率地	conj.  一…就…；	
dirt	[dɜ:t]	n.  泥土； 污垢，污泥； 下流想法； 恶意中伤的话	
disappear	[ˌdɪsəˈpɪə(r)]	vi.  不见，消失； 不复存在，灭绝；	
disaster	[dɪˈzɑ:stə(r)]	n.  灾难； 彻底的失败； 不幸； 祸患	
discard	None	None	
discharge	[dɪsˈtʃɑ:dʒ]	vt.  下（客）； 卸船； 免除（自己的义务、负担等）； 执行	vt.& vi.  放出； 流出； 开枪； 发射	n.  （气体、液体如水从管子里）流出； 排放出的物体；	vi.  （船、飞机等）卸货； （颜料、墨水或染料等）化开； 卸掉负担（或负载）； 下客	
discipline	[ˈdɪsəplɪn]	vt.  训练； 使有纪律； 处罚； 使有条理	n.  训练； 纪律； 学科； 符合行为准则的行为（或举止）	
discount	[ˈdɪskaʊnt]	vt.  打折扣； 打折出售； 认为…不重要； 低估	n.  折扣； 减价；	
discourage	[dɪsˈkʌrɪdʒ]	vt.  使气馁； 使沮丧； 阻碍； 劝阻	
disease	[dɪˈzi:z]	n.  疾病； 弊端； 不安；	vt.  传染； 使…有病；	
disguise	[dɪsˈgaɪz]	vt.  隐瞒，掩饰； 伪装，假装； 化装； 掩盖	n.  伪装； 伪装品； 用作伪装的东西； 托辞，借口	
disgust	[dɪsˈgʌst]	n.  反感，厌恶，嫌恶；	vt.  使反感，厌恶；	
dismiss	[dɪsˈmɪs]	vt.  解雇，把…免职； 遣散，解散（队伍等）； 驳回，拒绝受理； 搁置 不予考虑；摒弃；	vi.  解散；	
disorder	[dɪsˈɔ:də(r)]	n.  混乱，凌乱； 动乱，骚乱； 不正当行为； （身心机能的）失调	vt.  使混乱，使凌乱； 扰乱； 使（身心等）失调； 使（神经等）错乱	
display	[dɪˈspleɪ]	n.  展览，陈列； 陈列品，展览品； 显示器； 炫耀	vt.  显示； 陈列； 展开，伸展； 夸示，炫耀	vi.  （计算机屏幕上）显示；	
disposal	[dɪˈspəʊzl]	n.  （事情的）处置； （自由）处置权； 清理； 排列	adj.  处理（或置放）废品的；	
dispose	[dɪˈspəʊz]	vt.& vi.  处理，处置； 安排；	vt.  排列； 布置； 使倾向于，使有意于；	
dispute	[dɪˈspju:t]	vt.& vi.  辩论，争论；	vt.  就…进行争论，辩论； 对…的真实或有效进行争论，怀疑； 争夺，竞争； 抵抗，抵制	n.  辩论； 争端； （劳资）纠纷； 罢工	vi.  激烈争辩； 争执； 争吵； 吵架	
dissolve	[dɪˈzɒlv]	vt.  使溶解； 使（固态物）溶解为液体，使液化； 使消失，使消逝，消除； 使终止	vi.  溶解； 融化，液化； 解散，散去； 分裂，分解	
distinct	[dɪˈstɪŋkt]	adj.  明显的，清楚的； 卓越的，不寻常的； 有区别的； 确切的	
distinction	[dɪˈstɪŋkʃn]	n.  区别； 荣誉； 特质； 卓越	
distinguish	[dɪˈstɪŋgwɪʃ]	vi.  区分，辨别，分清； 辨别是非；	vt.  区分，辨别，分清； 辨别出，识别； 引人注目，有别于； 使杰出，使著名	
distress	[dɪˈstres]	n.  悲痛； 危难，不幸； 贫困； [法]扣押财物	vt.  使痛苦，使忧伤； [法]扣押（财物）； 使贫困；	
distribute	[dɪˈstrɪbju:t]	vt.  分配，散布； 散发，分发； 把…分类； [电]配电	
distribution	[ˌdɪstrɪˈbju:ʃn]	n.  分配，分布； [法]（无遗嘱死亡者的）财产分配； [无线]频率分布； [电]配电	
disturb	[dɪˈstɜ:b]	vt.  打扰，妨碍； 使骚动； 使不安，使烦恼； 妨碍睡眠（休息等）	
ditch	[dɪtʃ]	n.  沟渠； 壕沟；	vt.  摆脱，抛弃； 在…上掘沟； 把…开入沟里； 使（火车）出轨	vi.  使（飞机）在海上紧急降落，（在海上）迫降； 开沟；	
dive	[daɪv]	vi.  潜水； 跳水； 急剧下降； （头朝下）跳入水中	n.  潜水； 跳水； 俯冲，（潜艇）下潜； （气温，股价等的）暴跌，跳水	vt.& vi.  突然下降，暴跌；	
diverse	[daɪˈvɜ:s]	adj.  不同的，多种多样的； 变化多的； 形形色色的；	
divide	[dɪˈvaɪd]	vt.& vi.  分开； 分隔； 除以； 分配	n.  分水岭，分界线； 分歧；	
division	[dɪˈvɪʒn]	n.  分开，分隔； [数]除法； 部门； [军]师	
divorce	[dɪ'vɔ:s]	n.  离婚； 分离；	vt.  与…离婚； 分离；	vt.& vi.  与（某人）离婚，判（某人）离婚；	
document	[ˈdɒkjumənt]	n.  （计算机）文档，证件； 公文；	vt.  证明； 记录； 为…提供证明；	
domestic	[dəˈmestɪk]	adj.  家庭的，家的； 国内的； 驯养的； 热心家务的	n.  佣人； 国货；	
dominant	[ˈdɒmɪnənt]	adj.  占优势的； 统治的，支配的； [生]显性的； 高耸的	n.  [生]显性性状，显性基因； 优势物种； [乐]全阶第五音； 主因，要素	
dominate	[ˈdɒmɪneɪt]	v.  支配，影响； 占有优势； 在…中具有最重要的特色； 在…中拥有最重要的位置	
donation	[dəʊˈneɪʃn]	n.  捐赠，赠送； 捐款； 捐赠物；	
donkey	[ˈdɒŋki]	n.  驴，毛驴； 笨蛋，傻瓜； （美国）民主党的象征；	
dorm	[dɔ:m]	n.  宿舍；	
dormitory	[ˈdɔ:mətri]	n.  （学校等的）宿舍； 集体寝室； （在市内工作的人的）郊外住宅区；	adj.  住宅区的；	
dose	[dəʊs]	n.  剂量，药量； （药的）一服，一剂； （处罚等）一回，一次，一番； （酒中的）配料，增味剂	vi.  服药；	vt.  给药； 给…服药； 把（药等）配分剂量； 在（酒）中加料	
extreme	[ɪkˈstri:m]	adj.  极端的，过激的； 极限的，非常的； 末端的； （政治上）急进的	n.  极端； 困境； [数]极限值； [常用复数]在两末端的事物	
eyesight	[ˈaɪsaɪt]	n.  视觉，视力； 见解，观察； 眼力；	
fabric	[ˈfæbrɪk]	n.  织物； 布； 构造； （建筑物的）结构（如墙、地面、屋顶）：质地	
facility	[fəˈsɪləti]	n.  设备，设施，便利条件； 容易； 能力，天赋； 灵巧	
factor	[ˈfæktə(r)]	n.  因素； 因子； 代理人；	vt.  把…因素包括进去； [数学]分解…的因子，将…分解成因子； 以代理商（或管家等）的身份行事，做代理商（或管家）；	vi.  做代理商（或管家）；	
faculty	[ˈfæklti]	n.  能力，才能； 全体教职员； （大学的）专科，系； 特权，特许	
fade	[feɪd]	vi.  褪去，失去光泽； 逐渐消逝； 凋谢，衰老；	vt.  使褪色；	adj.  乏味的，平淡的；	
failure	[ˈfeɪljə(r)]	n.  失败，不及格； 缺乏，不足； 破产，倒闭； 失败的事，失败者	
faint	[feɪnt]	adj.  微弱的，模糊的； 软弱的； 无勇气的； 将昏倒似的	vi.  头晕，昏过去； 渐渐不明，消失；	n.  昏厥，昏倒；	
fairly	[ˈfeəli]	adv.  适当，相当地； 公平地； 完全，简直； 清楚地	
fairy	[ˈfeəri]	n.  仙女； 小仙子； 小精灵；	adj.  美丽的，可爱的； 仙女似的；	
faith	[feɪθ]	n.  信用，信任； 信仰，信念； 忠诚； 宗教	int.  实在，确实；	
faithful	[ˈfeɪθfl]	adj.  忠实的； 忠诚的； 正确的；	n.  信徒；	
fame	[feɪm]	n.  名声； 名望； 传闻； 传说	vt.  使闻名； 使出名； 使有名望； 盛传	
famine	[ˈfæmɪn]	n.  饥荒； 饥饿； 极度缺乏；	
fancy	[ˈfænsi]	vt.  认为； 想象； 想要； 自命不凡	n.  想象的事物； 想象力； 爱好； 想要	adj.  精致的； 花哨的； 昂贵的； 异常复杂的 豪华的；	
fantastic	[fænˈtæstɪk]	adj.  极好的； 很大的； 怪诞的； 不切实际的	
fantasy	[ˈfæntəsi]	n.  幻想； 空想的产物； 幻想作品； 非正式的货币	vt.& vi.  想像； 幻想； 奏幻想曲；	
fare	[feə(r)]	n.  费； 票价； 乘客； 食物	vi.  吃； 进食； 进展； 遭遇	
farewell	[ˌfeəˈwel]	n.  告别，欢送； 欢送会； 告别辞；	int.  再见，再会； 一路平安；	adj.  告别的，送行的；	
fascinating	[ˈfæsɪneɪtɪŋ]	adj.  迷人的，有极大吸引力的； 使人神魂颠倒的；	v.  使…陶醉(fascinate的ing形式)；	
fashion	[ˈfæʃn]	n.  时尚，时装； 时装领域，时尚界； 方式，方法；	vt.  制作，塑造； 使适应；	
fashionable	[ˈfæʃnəbl]	adj.  流行的； 时髦的，符合时尚的； 时髦人物使用的； （尤指）有钱人常光顾的	n.  时髦的人；	
fasten	[ˈfɑ:sn]	vt.  系牢，钉牢； 使坚固或稳固； 使合在一起：封合； 集中：稳定地集中或指向：	vi.  附着，扣紧； 紧握，紧抱； 集中：显著地注意，集中；	
fatal	[ˈfeɪtl]	adj.  致命的，攸关的； 毁灭性的，严重的； 命中注定的； 重大的	
fate	[feɪt]	n.  命运； 天意； 命中注定的事（尤指坏事）；	
fatigue	[fəˈti:g]	n.  疲劳，疲乏； 劳务杂役； （士兵穿的）工作服；	vt.  使疲劳； 使疲乏；	vi.  疲劳；	
faulty	[ˈfɔ:lti]	adj.  错误的； 有错误的，有过失的，有缺点的； 不完美的；	
favour	[ˈfeɪvə(r)]	n.  帮助； 恩惠； 赞同； 善行	vt.  喜爱； 有利于； 赞同； 容貌像…	
favourable	[ˈfeɪvərəbl]	adj.  顺利的，良好的； 有利的； 赞许的； 给人好印象的	
favourite	[ˈfeɪvərɪt]	adj.  特别受喜爱的；	n.  特别喜爱的人（或物）； 夺冠热门；	
fearful	[ˈfɪəfl]	adj.  害怕的，担心的； 胆怯的； 吓人的，可怕的； 极端的	
feasible	[ˈfi:zəbl]	adj.  可行的； 可用的； 可实行的； 可能的	
feather	[ˈfeðə(r)]	n.  羽毛，翎毛； 状态，心情； 种类； 桨叶的水平运动	v.  给装上羽毛，用羽毛装饰； 使（桨）与水面平行； 长羽毛；	
feature	[ˈfi:tʃə(r)]	n.  特征，特点； 容貌，面貌； （期刊的）特辑； 故事片	vt.  使有特色； 描写…的特征； 以…为号召物；	vi.  起主要作用； 作重要角色；	
federal	[ˈfedərəl]	adj.  联邦（制）的； 同盟的；	n.  联邦主义者； 同盟盟友；	
fee	[fi:]	n.  （加入组织或做某事付的）费； 专业服务费，业务报酬； 小费，赏钱； [法] 继承的产业	vt.  付给报酬，给小费； 〈英〉雇用，聘请；	
feedback	[ˈfi:dbæk]	n.  反馈； 反应； 反馈噪音；	
female	[ˈfi:meɪl]	adj.  女性的； 雌性的； 能结果实的； 电气设备阴的	n.  女人； 雌性动物； 雌性植物，雌株；	
fertile	[ˈfɜ:taɪl]	adj.  肥沃的； 可繁殖的； 想象力丰富的；	
fertilizer	[ˈfɜ:təlaɪzə(r)]	n.  肥料，化肥； 受精媒介物； 促进发展者；	
festival	[ˈfestɪvl]	n.  节日； 节期； 贺宴，会演；	adj.  节日的，喜庆的；	
fibre	[ˈfaɪbə(r)]	n.  纤维； 性格； 硬纸板纤维板；	
fiction	[ˈfɪkʃn]	n.  小说，虚构的文学作品； 虚构的或想像出的事，并非完全真实的事； 编造，虚构；	
fierce	[fɪəs]	adj.  凶猛的，残忍的； 猛烈的； 狂热的；	
figure	[ˈfɪgə(r)]	n.  数字； 算术； 人物； 身材	vi.  计算； 出现； 扮演角色；	vt.  计算在内； 估计； 推测； 认为	
filter	[ˈfɪltə(r)]	n.  滤波器； 滤光器； 滤色镜； [化] 过滤器	vi.  过滤； 透过； 渗透；	vt.  过滤； 滤除；	
finally	[ˈfaɪnəli]	adv.  最后，终于； 总算； 末后； 结果	
finance	[ˈfaɪnæns]	n.  财政； 金融； 财源； 资金	vt.  为…供给资金， 从事金融活动； 赊货给…； 掌握财政；	
financial	[faɪˈnænʃl]	adj.  财政的； 财务的； 金融的； 有钱的	
finding	[ˈfaɪndɪŋ]	n.  发现物； 研究结果； 调查（或研究）的结果； （陪审团的）裁决	v.  发现( find的现在分词)；	
fireman	[ˈfaɪəmən]	n.  消防队员； [矿]救火员，爆破工； 司炉工；	
fisherman	[ˈfɪʃəmən]	n.  渔夫，渔民；	
flame	[fleɪm]	n.  火焰； 热情，激情； 〈俚〉爱人，情人； 激动	vi.  燃烧，发出火焰； 面红； 闪光；	vt.  烧； 激起，激怒；	
flash	[flæʃ]	vt.& vi.  使闪光，使闪烁； 拍出，发出（电报等）； 〈口〉炫耀；	n.  闪光； 闪光灯下摄成的照片； 一瞬间； 浮华	adj.  闪光的，闪耀的，一闪而过的； 浮华的； 庞大的；	
flat	[flæt]	adj.  平的； 单调的； 不景气的； 干脆的	adv.  （尤指贴着另一表面）平直地； 断然地； 水平地； 直接地，完全地	n.  平地； 公寓； 平面；	vt.  使变平； [音乐]使（音调）下降，尤指降半音；	vi.  逐渐变平； [音乐]以降调唱（或奏）；	
flee	[fli:]	vi.  逃走，逃掉； 消失；	vt.  逃离，逃避；	
fleet	[fli:t]	n.  舰队； 船队； 车队； 港湾，小河	adj.  快速的，敏捷的； 转瞬即逝的；	vi.  疾驰； 飞逝；	vt.  使（时间）飞逝； 消磨；	
flesh	[fleʃ]	n.  肉； 肉体； 果肉； 皮肤	v.  用肉喂养； 长胖；	
flexible	[ˈfleksəbl]	adj.  灵活的； 易弯曲的； 柔韧的； 易被说服的	
float	[fləʊt]	vt.& vi.  （使）浮动； （使）漂浮； 自由浮动；	vi.  游荡；	vt.  提出，提请考虑； （股票）上市； 试探性提出；	n.  彩车； 漂浮物； 浮板； 浮有冰淇淋的饮料	
flock	[flɒk]	n.  兽群，鸟群； 群众； 棉束； 大堆，大量	vi.  群集，成群结队而行；	vt.  用棉束填；	
flood	[flʌd]	n.  洪水； 泛滥； 溢流； 探照灯	vi.  涌出； 为水淹没；	vt.  淹没；	
flour	[ˈflaʊə(r)]	n.  面粉；	vt.  撒上粉；	
flourish	[ˈflʌrɪʃ]	vi.  挥舞； 茂盛，繁荣； 活跃，蓬勃；	vt.  挥动，挥舞；	n.  挥舞，挥动； 花样，华丽的辞藻； 夸张的行为或手势； 花式吹奏	
fluent	[ˈflu:ənt]	adj.  流畅的； 流利的； 液态的；	
fluid	[ˈflu:ɪd]	n.  液体，流体；	adj.  流体的，流动的，流体的，液体的； 易变的，不固定的； （动作、设计、音乐等）流畅优美的；	
focus	[ˈfəʊkəs]	vt.& vi.  （使）集中，（使）聚集； 调整（镜头，眼睛）焦点[焦距]以便看清；	vt.  调整（眼睛或者镜头的）焦距； 集中（光束于）； 聚焦，注视； 集中注意力	n.  焦点； 影象的清晰度； （活动、注意力、兴趣等的）中心； [医]病灶，病症	
fog	[fɒg]	n.  雾； 烟雾； 迷惑； 割后再生的草	vt.  以雾包围； 使模糊； 使迷惑；	vi.  为雾笼罩； 朦胧； 照片（模糊）；	
fold	[fəʊld]	vt.  折叠； 合拢； 抱住； 笼罩	vi.  折叠起来； 彻底失败；	n.  折痕； 信徒； 羊栏； （起伏地的）凹处，洼	
folk	[fəʊk]	n.  民族； 人们； 〈口〉家属，亲戚； 民间音乐	adj.  民间的； 普通平民的； 流传民间的； 普通百姓的	
following	[ˈfɒləʊɪŋ]	adj.  后面的，其次的； 下列的； 顺风的；	n.  崇拜者，拥护者； 下列，如下； 跟随； 随球	prep.  随后，在…以后；	v.  跟随，接着(follow的现在分词)；	
footstep	[ˈfʊtstep]	n.  脚步（声）； 足迹；	
forbid	[fəˈbɪd]	vt.  禁止； 阻止； 阻碍； 妨碍	
force	[fɔ:s]	n.  力； 武力； （社会）势力； 魄力	vt.  强迫； 强行； 促使，推动； 强奸	
forecast	[ˈfɔ:kɑ:st]	vt.  预报，预测； 预示；	vi.  预报，预测；	n.  预报； 预言；	
forehead	[ˈfɔ:hed]	n.  额； 前部；	
forge	[fɔ:dʒ]	n.  锻造车间； 熔铁炉，锻铁炉； 铁匠铺，铁匠工场；	vi.  锻制，锻造； 伪造； 犯伪造罪；	vt.  锻造； 伪造； 捏造，编造； 制订	
formal	[ˈfɔ:ml]	adj.  （学校教育或培训）正规的； 方式上的； 礼仪上的；	n.  须穿礼服的社交集会； 夜礼服；	
format	[ˈfɔ:mæt]	n.  （出版物的）版式； [自]（数据安排的）形式； 电视节目的总安排（或计划）；	vt.  使格式化； 安排…的格局； 设计…的版面；	vi.  设计一个版式；	
formation	[fɔ:ˈmeɪʃn]	n.  形成； 构成，结构； 形成物； 编队，队形 奇峰，怪石，某种形状的云；	
horizontal	[ˌhɒrɪˈzɒntl]	adj.  水平的，卧式的； 地平线的； [植]（枝条）平层的； 同一行业的，同阶层的	n.  水平线； 水平面； 水平位置； 水平的物体	
horn	[hɔ:n]	n.  角，触角； 号角，喇叭； 角质； 角状物	vi.  不请自来； 闯入；	
horrible	[ˈhɒrəbl]	adj.  可怕的； 极不友好的； 极讨厌的； 令人震惊的	
horror	[ˈhɒrə(r)]	n.  恐怖，可怕的事物； 嫌恶，痛恨； 讨厌的人或事； 〈口〉非常丑恶	
horsepower	[ˈhɔ:spaʊə(r)]	n.  马力；	
hostile	[ˈhɒstaɪl]	adj.  敌人的，敌对的； 怀有敌意的； 不利的；	n.  敌对者，敌对物； 敌方；	
household	[ˈhaʊshəʊld]	n.  家庭，户； （集合词）全家人，（包含人在内的）家眷，家属，家里人； 家庭； （英）王室	adj.  家喻户晓的； 皇家的；	
housing	[ˈhaʊzɪŋ]	n.  房屋； 供给住宅； 掩护； 外罩	
humble	[ˈhʌmbl]	adj.  谦逊的； 简陋的； （级别或地位）低下的； 不大的	vt.  使谦恭； 轻松打败（尤指强大的对手）； 低声下气；	
humorous	[ˈhju:mərəs]	adj.  幽默的； 滑稽的； 风趣的； 谐	
humour	[ˈhju:mə(r)]	n.  幽默； 幽默感 ； 感觉； 体液	v.  迁就； 顺应；	
hunt	[hʌnt]	vt.& vi.  打猎； 猎取；	vt.  打猎； 追捕，猎杀； 在…处狩猎； 搜索	vi.  追逐猎物； 寻找； 前后摆动； 积极地寻找	n.  打猎； 狩猎旅行； 参加狩猎旅行的人；	
hut	[hʌt]	n.  小屋； 棚屋； 临时营房； 牢房	v.  使住临时营房； 驻扎；	
hydrogen	[ˈhaɪdrədʒən]	n.  氢；	
ideal	[aɪˈdi:əl]	adj.  理想的，完美的； 被认为是最好的； 完全或相当令人满意的； 想象的，假设的	n.  理想； 典范，典型； 目标，高尚的、有价值的原则或目标；	
identical	[aɪˈdentɪkl]	adj.  同一的； 完全同样的，相同的； 恒等的； 同卵的	n.  完全相同的事物； 同卵双胞；	
identify	[aɪˈdentɪfaɪ]	vt.  识别，认出； 确定； 使参与； 把…看成一样	vi.  确定； 认同；	
identity	[aɪˈdentəti]	n.  身份； [逻]同一性； 个性； [数]恒等（式）	
idle	[ˈaɪdl]	adj.  无意义的； 空闲的； 懒惰的； 无根据的	vi.  虚度； 空转； 挂空挡； 未熄火	vt.  虚度； 使空转；	n.  （尤指暂时地）关闭工厂，使（工人）闲着；	
ignorance	[ˈɪgnərəns]	n.  无知，愚昧； 蒙；	
ignorant	[ˈɪgnərənt]	adj.  无知的，愚昧的； 由无知引起的； 无学识的；	
ignore	[ɪgˈnɔ:(r)]	vt.  忽视，不顾； [法律]驳回（诉讼）；	
illegal	[ɪˈli:gl]	adj.  不合法的，违法的； 违反规则的；	n.  非法移民，非法劳工； 间谍；	
illustrate	[ˈɪləstreɪt]	vt.  说明； 表明； 给…加插图； （用示例、图画等）说明	vi.  举例说明；	
illustration	[ˌɪləˈstreɪʃn]	n.  说明； 例证； 图解； 插图	
image	[ˈɪmɪdʒ]	n.  影像； 肖像； 概念，意向； 镜像，映像	
imaginary	[ɪˈmædʒɪnəri]	adj.  想像中的，假想的，虚构的； [数]虚数的； 幻； 虚幻	
imagination	[ɪˌmædʒɪˈneɪʃn]	n.  想象，想象力； 空想，妄想； 想象出来的事物；	
imitate	[ˈɪmɪteɪt]	vt.  模仿，效仿； 仿造，伪造；	
immediately	[ɪˈmi:diətli]	adv.  立即，马上； 直接地； 紧接地；	conj.  一…就，即刻；	
immense	[ɪˈmens]	adj.  极大的，巨大的； 浩瀚的，无边际的； 〈口〉非常好的； 弘道	
immigrant	[ˈɪmɪgrənt]	n.  移民，侨民； 从异地移入的动物[植物]；	adj.  移民的，移来的； 侨民的；	
impact	[ˈɪmpækt]	n.  碰撞，冲击，撞击； 影响； 冲击力；	vt.  挤入，压紧； 撞击； 对…产生影响；	vi.  冲撞，冲击； 产生影响；	
impatient	[ɪmˈpeɪʃnt]	adj.  不耐烦的； 热切的，渴望的； 不能容忍的，恼火的；	
implement	[ˈɪmplɪment]	vt.  实施，执行； 使生效，实现； 落实（政策）； 把…填满	n.  工具，器械； 家具； 手段； [法]履行（契约等）	
implication	[ˌɪmplɪˈkeɪʃn]	n.  含义； 含蓄，含意，言外之意； 卷入，牵连，牵涉，纠缠； [逻辑学]蕴涵，蕴含	
imply	[ɪmˈplaɪ]	vt.& vi.  暗示； 意味； 隐含； 说明，表明	
import	[ˈɪmpɔ:t]	n.  进口，进口商品； 输入； 重要性； 意义	vt.  输入，进口； 对…有重大关系； 意味着；	vi.  具重要性；	
impose	[ɪmˈpəʊz]	vt.  强加； 征税； 以…欺骗；	vi.  利用； 欺骗； 施加影响；	
impress	[ɪmˈpres]	vt.  印； 给…以深刻印象； 使铭记；	n.  印象； 印记；	
impression	[ɪmˈpreʃn]	n.  印象，感觉； 影响，效果； 盖印，印记；	
impressive	[ɪmˈpresɪv]	adj.  给人印象深刻的，感人的； 引人注目的； 可观的； 显赫	
improve	None	None	
improvement	[ɪmˈpru:vmənt]	n.  改进，改善，改良，增进，进步； （美）装修，改良措施； 利用，活用； 更优秀的人，更进步的人	
incident	[ˈɪnsɪdənt]	n.  事件，事变； 小插曲； 敌对行动； 骚乱	adj.  [法]附带的； [光]入射的； 易有的，附随的；	
incline	[ɪnˈklaɪn]	vt.& vi.  （使）倾斜，弄斜； （使）偏向，倾向于； （使）认为； 点（头）（以示同意、打招呼等）	n.  斜坡； 斜面； 坡度； 倾斜	
include	[ɪnˈklu:d]	vt.  包括； 包含； 计入； 包住	
increasingly	[ɪnˈkri:sɪŋli]	adv.  越来越多地； 日益，格外； 越来越…； 愈	
incredible	[ɪnˈkredəbl]	adj.  不可思议的； 惊人的； 难以置信的； 未必可能的	
independence	[ˌɪndɪˈpendəns]	n.  独立，自主； 足够维持闭居生活的收入； 独立心； 自恃心	
independent	[ˌɪndɪˈpendənt]	adj.  自主的； 不相关连的； 无党派的； 不相干的人所做的（或提供的）	n.  独立自主的人； 无党派人士；	
index	[ˈɪndeks]	n.  索引； 指数； 指示； 标志	vt.  给…编索引； 把…编入索引； [经济学]按生活指数调整（工资、价格等）；	vi.  [机械学]转位；	
indicate	[ˈɪndɪkeɪt]	vt.  表明，标示，指示； 象征，暗示，预示； [医]显示需要做…的治疗；	
indication	[ˌɪndɪˈkeɪʃn]	n.  指示； 象征； 表明； 标示	
indifferent	[ɪnˈdɪfrənt]	adj.  漠不关心的； 无关紧要的； 中立的； 中等的	
indirect	[ˌɪndəˈrekt]	adj.  间接的； 不直截了当的； 闪烁其词的； 不坦率的	
indispensable	[ˌɪndɪˈspensəbl]	adj.  不可缺少的； 绝对必要的； 责无旁贷的； 不可避开的	n.  不可缺少的人或物；	
individual	[ˌɪndɪˈvɪdʒuəl]	adj.  个人的； 独特的； 个别的；	n.  个人； 个体；	
indoor	[ˈɪndɔ:(r)]	adj.  室内的，户内的； 在室内使用的； 待在家里的； 救济院内的	
industrial	[ɪnˈdʌstriəl]	adj.  工业的，产业的； 从事工业的； 供工业用的； 来自勤劳的	n.  工业股票； 工业工人；	
industrialize	[ɪnˈdʌstriəlaɪz]	vt.& vi.  （使）工业化；	
inevitable	[ɪnˈevɪtəbl]	adj.  不可避免的； 必然发生的； 总会发生的； 必然发生的事	
infant	[ˈɪnfənt]	n.  婴儿，幼儿； 未成年人； 初学者，生手；	adj.  婴儿的，幼儿的； 幼稚的，幼小的； 初期的； 未成年的	
infect	[ɪnˈfekt]	vt.  使受影响，感染； 传染，散布病毒，侵染； （电脑病毒）使（电脑的）存储器[数据]受到感染；	
infer	[ɪnˈfɜ:(r)]	vt.  推断； 猜想，推理； 暗示； 意指	vi.  作出推论；	
inference	[ˈɪnfərəns]	n.  推理； 推断； 推论；	
inferior	[ɪnˈfɪəriə(r)]	adj.  （质量等）低劣的； 下级的，下等的； （位置在）下面的； [植]下位的	n.  部下，下属； 次品； 晚辈； [印]下角码	
infinite	[ˈɪnfɪnət]	adj.  无限的，无穷的； 无数的，许许多多的； 极大的；	n.  无限，无穷； [数] 无穷大； 造物主，神； 无限的事物	
inflation	[ɪnˈfleɪʃn]	n.  膨胀； 通货膨胀； 夸张； 自命不凡	
influence	[ˈɪnfluəns]	n.  影响； 势力； 有影响的人（或事物）； [占星学]星力	vt.  影响； 感染； 支配； 对…起作用	
influential	[ˌɪnfluˈenʃl]	adj.  有影响的； 有权势的；	n.  有影响力的人物；	
inform	[ɪnˈfɔ:m]	vt.  通知； 使活跃，使充满； 预示；	vi.  通知； 告发；	
ingredient	[ɪnˈgri:diənt]	n.  （混合物的）组成部分； （烹调的）原料； （构成）要素； 因素	
inhabitant	[ɪnˈhæbɪtənt]	n.  居民，住户； （栖息在某地区的）动物；	
inherit	[ɪnˈherɪt]	vt.& vi.  继承；	vt.  经遗传获得（品质、身体特征等），继任；	
initial	[ɪˈnɪʃl]	adj.  最初的； 开始的； 首字母的；	n.  首字母； [语音学]声母； 特大的大写字母；	vt.  用姓名的首字母签名；	
initiative	[ɪˈnɪʃətɪv]	n.  主动性； 主动精神； 倡议； 主动权	adj.  自发的； 创始的； 初步的；	
injection	[ɪnˈdʒekʃn]	n.  注射； 注射剂； [医]充血； （卫星等的）入轨	
injure	[ˈɪndʒə(r)]	vt.  损害，毁坏； 伤害（名誉、自尊等）； （尤指事故中）伤害； 伤害（感情，自尊心等）	
injury	[ˈɪndʒəri]	n.  伤害，损害； 受伤处； 伤害的行为；	
inn	[ɪn]	n.  小旅馆，客栈； 小饭店，小酒馆；	vi.  住旅馆；	
lower	[ˈləʊə(r)]	adj.  下方的； 在底部的； 较低级的；	v.  降低； 减少； 缩小；	
loyal	[ˈlɔɪəl]	adj.  忠诚的，忠心的； 忠贞的；	n.  效忠的臣民； 忠实信徒；	
loyalty	[ˈlɔɪəlti]	n.  忠诚，忠实； 忠心； 忠于…感情；	
lucky	[ˈlʌki]	adj.  运气好的，侥幸的； 兆头好的，吉祥的； 〈俚〉难得； 很恰当的	
luggage	[ˈlʌgɪdʒ]	n.  行李； 皮箱；	
lump	[lʌmp]	n.  块，团； 肿块； 许多，大量； 笨拙的人	vi.  结成块； 成团； 笨重地行走；	vt.  使成团，使成块； 使团结在一起； 把…混在一起；	adj.  成团的，成块的；	adv.  很，非常；	
lung	[lʌŋ]	n.  肺； 呼吸器官； [医]辅助呼吸的装置； 〈英〉可供呼吸新鲜空气的地方	
luxury	[ˈlʌkʃəri]	n.  奢侈，豪华； 奢侈品，美食，美衣； 乐趣，享受； 不常有的乐趣（或享受、优势）	adj.  奢华的，豪华的；	
machinery	[məˈʃi:nəri]	n.  （总称）机器； （政府等的）机关，组织； 机器的运转部份； 机械装置	
magic	[ˈmædʒɪk]	n.  魔法； 巫术； 戏法； 不可思议的魔力	adj.  魔术的； 幻术的； 不可思议的； 有魔力的 神奇的；	v.  用魔法变出； 用魔法摆脱； 用魔法得到； 使中邪	
magnet	[ˈmægnət]	n.  磁铁，磁石； 有吸引力的人或物； [物]磁体；	
magnetic	[mægˈnetɪk]	adj.  有磁性的，有吸引力的； 磁性的； 有吸引力的； 有魅力的	
magnificent	[mægˈnɪfɪsnt]	adj.  壮丽的； 伟大的，高尚的； 华丽的，高贵的； 瑰丽的	
maid	[meɪd]	n.  女仆，侍女； 少女； 处女，未婚女子；	
mainland	[ˈmeɪnlænd]	n.  大陆； 本土；	adj.  大陆的； 本土的；	
maintain	None	None	
maintenance	[ˈmeɪntənəns]	n.  维持，保持； 保养，保管； 维护； 维修	
major	[ˈmeɪdʒə(r)]	adj.  主要的； 重要的； 大调的； 主修的（课程）	n.  主修科目； 大调； 陆军少校； 主修学生	v.  主修，专攻；	
majority	[məˈdʒɒrəti]	n.  多数； （获胜的）票数； 成年； 法定年龄	
male	[meɪl]	adj.  男性的； 雄性的； 有力的； [植]雄性的，仅有雄蕊的	n.  男； 雄性动物； [植]雄性植物； 马累[马律]	
management	[ˈmænɪdʒmənt]	n.  管理； 管理人员； 管理技巧，处事的能力；	
mankind	[mænˈkaɪnd]	n.  人类； 男性，男子；	
manner	[ˈmænə(r)]	n.  方式，方法，做法； 态度，样子，举止； 礼貌，规矩； 风俗，习惯，惯例，生活方式	
manual	[ˈmænjuəl]	adj.  用手的； 手制的，手工的； [法]占有的； 体力的	n.  手册； 指南； [乐]键盘； [军]刀枪操练	
manufacture	[ˌmænjuˈfæktʃə(r)]	vt.  制造，生产； 捏造，虚构； 加工； 从事制造	n.  大量制造； 批量生产； 工业品；	
manufacturer	[ˌmænjuˈfæktʃərə(r)]	n.  制造商，制造厂； 厂主； [经]厂商；	
margin	[ˈmɑ:dʒɪn]	n.  边缘，范围； 极限； 利润，盈余； （版心外）的空白	vt.  留边； 成为…的边； 加边于，围绕； 为…加旁注	
marine	[məˈri:n]	adj.  海的； 海产的； 海军的； 海事的	n.  水兵； 海军陆战队士兵； 海事，海运业；	
market	[ˈmɑ:kɪt]	n.  交易； 市集； 需求； 交易情况，行情	vt.  在市场上出售某物； 推销；	vi.  去市场买东西；	
marriage	[ˈmærɪdʒ]	n.  结婚； 婚姻生活； 密切结合； 合并	
married	[ˈmærid]	adj.  已婚的； 与…结为夫妻的； 婚姻的；	n.  已婚的年轻人；	v.  （使）结婚( marry的过去式)； 娶； 嫁； 紧密结合的	
marry	[ˈmæri]	vt.& vi.  （使）结婚； 娶； 嫁； 结合	vt.  为…主持婚礼；	
marvelous	['mɑ:vɪləs]	adj.  引起惊异的； 不可思议的； 非凡的； 神乎其神	
Marxist	['mɑ:ksɪst]	n.  马克思主义者；	adj.  马克思主义的；	
mask	[mɑ:sk]	n.  面具； 假面具； 用作掩饰的事物； 护肤膜	vt.  掩饰； 戴面具； 用面具遮住，掩盖，掩饰；	vi.  戴面具； 隐瞒，掩饰；	
mass	[mæs]	n.  大量，大多； 块，堆，团； [物理学]质量； 弥撒曲	vt.& vi.  （使）集中，聚集；	adj.  群众的； 大规模的； 整个的； 集中的	vi.  聚集起来；	vt.  使集合；	
massive	[ˈmæsɪv]	adj.  大的，重的； 大块的，大量的； 魁伟的，结实的； 大规模的	
mat	[mæt]	n.  席子，垫子； （体育运动用的）厚垫子； 衬边； 团，簇	vt.  遮盖，用垫子作装饰； 使…缠结； 给（照片）镶框； 使…表面无光	vi.  缠结；	adj.  粗糙的； 暗淡的，无光泽的；	
mate	[meɪt]	n.  （工人间的）伙伴，同事，老兄，老弟〔工人，水手间的亲密称呼〕； 配偶〔男女任何一方〕，动物之偶（尤指鸟类），（一对中的）一只，配对物； [医学]（军医等的）助手； [航海]（商船的）大副，驾驶员	vt.& vi.  （使）成为配偶； （使）交配； （一对动物或鸟）交配； 交尾(~ with sth)	
material	[məˈtɪəriəl]	n.  材料，原料； 素材； 布，织物； 适当人选	adj.  物质的； 肉体的； 重要的，决定性的； 辩证的，推论的	
mathematical	[ˌmæθə'mætɪkl]	adj.  数学的； 精确的； 绝对的； 可能性极小的	
mathematics	[ˌmæθəˈmætɪks]	n.  数学； 〈诗〉同“ripen”； 算学；	
mature	[məˈtʃʊə(r)]	adj.  （人、树木、鸟或动物）成熟的； 仔细考虑过的； 到期（应该支付）的； 成年人的	vi.  成熟，长成； （票据等）到期；	vt.  使…成熟； 使…长成； 慎重拟定（计划等）；	
maximum	[ˈmæksɪməm]	adj.  最大值的，最大量的；	n.  最大的量、体积、强度等；	
mayor	[meə(r)]	n.  市长； 镇长； （英格兰、威尔士和北爱尔兰由议员选举产生的）镇长； （民选的）市长	
meaning	None	None	
means	[mi:nz]	n.  方法； 手段； 收入； 财富	v.  意味着（ mean的第三人称单数）； 引起； 打算或注定要某人成为或做某事；	
meantime	[ˈmi:ntaɪm]	n.  其时，其间；	adv.  同时，其间；	
meanwhile	[ˈmi:nwaɪl]	adv.  同时，其间；	n.  其时，其间；	
measure	[ˈmeʒə(r)]	n.  测量，测度； 措施； 程度； 尺寸	vt.  测量； 估量；	vi.  测量； 测量（大小，容量，尺寸等）；	
measurement	[ˈmeʒəmənt]	n.  量度； 份量，尺寸； 测量法； （量得的）尺寸	
mechanic	[məˈkænɪk]	n.  技工，机修工；	
mechanical	[məˈkænɪkl]	adj.  机械的，机械学的； 呆板的； 体力的； 手工操作的	
mechanism	None	None	
medal	[ˈmedl]	n.  奖章，奖牌； 勋章； 纪念章； 证章	vi.  获奖：赢得一枚奖章；	vt.  授予…奖章；	
media	[ˈmi:diə]	n.  媒体； [解剖学]血管中层； [语音学] 浊塞音； 介质 [医]培养基；	
medium	[ˈmi:diəm]	adj.  中等的，中级的； 普通的； 平均的； 五分熟的	n.  媒介物，媒质； 中间，中庸，[生]培养基，培养液，颜料溶解液，[数]中数，平均，[逻]中名辞； 手段，方法； 中间物 中号；	
melt	[melt]	vi.  熔化，溶解； 逐渐融合； 逐渐消失； 感动，软化，感情上变得温和	vt.  熔化，溶解； 使混合在一起； 逐渐消散； 使变得温和或温柔	
membership	[ˈmembəʃɪp]	n.  会员资格； 会员身份； 会员全体；	
memorial	[məˈmɔ:riəl]	n.  纪念碑，纪念物； 纪念仪式；	adj.  纪念的； 悼念的；	
mental	[ˈmentl]	adj.  内心的，精神的，思想的，心理的； 智慧的，智[脑]力的； 〈口〉精神病的，意志薄弱的，愚笨的；	n.  精神病患者；	
mention	[ˈmenʃn]	vt.  提到，说起； 提名表扬；	n.  提及；	
menu	[ˈmenju:]	n.  菜单； 菜，菜肴；	
merchant	[ˈmɜ:tʃənt]	n.  商人； 批发商； 店主； 零售商	adj.  商人的； 商业的；	
mercy	[ˈmɜ:si]	n.  宽容； 怜悯； 幸运； 侥幸	
mere	[mɪə(r)]	adj.  仅仅，只不过； 小的，轻微的； 纯粹的；	n.  小湖，池塘； 〈英〉边境（线）；	
merely	[ˈmɪəli]	adv.  仅仅，只不过； 只是； 纯粹； 全然	
merit	[ˈmerɪt]	n.  价值，优点； [宗教]（行善得到的）功德； 功绩，功勋； 荣誉	vt.  值得，应获得； [宗教]（因行善而）应得（善报）；	vi.  值得，应得； [宗教]积德；	
merry	[ˈmeri]	adj.  愉快的，快活的； 有趣的； [口]微醉的； 生动的	n.  甜樱桃； 梅里（姓氏）；	
mess	[mes]	n.  混乱； 食堂； 肮脏； 困境	vt.  弄脏； 搞砸； 给…供膳；	vi.  把事情弄糟； 制造脏乱；	
metric	[ˈmetrɪk]	adj.  米制的，公制的，十进制的； 度量的； 距离的；	n.  度量标准； [数学]度量； 诗体，韵文，诗韵；	
microphone	[ˈmaɪkrəfəʊn]	n.  扩音器，麦克风； 话筒；	
microscope	None	None	
mild	[maɪld]	adj.  温柔的； 温暖的； 轻微的； （味道）不浓的	n.  淡味麦芽啤酒；	
military	[ˈmɪlətri]	adj.  军事的； 军用的； 讨厌的； 好战的	n.  军人； 军队； 武装力量；	
mill	[mɪl]	n.  磨坊； 磨粉机； 榨汁机； 工厂	vt.  研磨，粉碎； 搅拌； 磨，铣； 轧花边（在纸币上）	vi.  惊跑，乱闯； 经研磨；	
millimetre	[ˈmɪlimi:tə(r)]	n.  毫米；	
mineral	[ˈmɪnərəl]	n.  矿物； 矿石； 矿物质； 汽水	adj.  矿物的，似矿物的；	
minimum	[ˈmɪnɪməm]	n.  最低限度； 最小量； 最低消费； [数]极小值	adj.  最低的； 最小的； 最少的；	
minister	[ˈmɪnɪstə(r)]	n.  大臣； 部长； 公使； 牧师	vi.  辅助，服侍； 执行牧师职务；	
ministry	[ˈmɪnɪstri]	n.  （政府的）部； 神职； 牧师职位； 神职任期	
painful	[ˈpeɪnfl]	adj.  痛苦的； （肉体）疼的； 费力的，（工作）困难的； 讨厌的，使人厌烦的	
painter	[ˈpeɪntə(r)]	n.  画家，着色者； 油漆匠； （系船的）缆绳； 破诡计	
palm	[pɑ:m]	n.  手掌； 手心； 棕榈树 ； 由Palm公司发明的一种PDA上的操作系统	v.  将…藏于掌中；	
panel	[ˈpænl]	n.  镶板； 面； （门、墙等上面的）嵌板； 控制板	vt.  选定（陪审团）； 把…分格； 在…上置鞍垫； 把…镶入框架内	
panic	[ˈpænɪk]	n.  恐慌，惊慌； （金融方面）大恐慌； 成功； 〈俚〉非常滑稽的人	vt.  使恐慌；	vi.  十分惊慌；	adj.  恐慌的，惊慌失措的；	
pants	[pænts]	n.  （紧身的）短裤；  裤子； 喘气( pant的名词复数 )；	v.  喘气，喘息( pant的第三人称单数 )； 喘着气说；	
parade	[pəˈreɪd]	v.  游行； 展览； 招摇过市； 接受检阅	n.  检阅； 游行； 阅兵； 队列 炫耀；	
paragraph	[ˈpærəgrɑ:f]	n.  段落； 分段符号；	vt.  将…分段； 写短文报导；	
parallel	[ˈpærəlel]	adj.  平行的； 相同的，类似的； [电]并联的； [计]并行的	adv.  平行地，并列地；	n.  平行线（面）； 相似物； 类比； 纬线	vt.  使平行； 与…媲美； 与…相比； 与…相似	
parcel	[ˈpɑ:sl]	n.  包袱，包裹； （土地的）一块； 一批，一群； （货物的）一宗	vt.  分，区分； 把…划成部分后分配； 给…打成包裹； 把…拼在一起	
parliament	[ˈpɑ:ləmənt]	n.  议会，国会；	
partial	[ˈpɑ:ʃl]	adj.  部分的； 偏爱的； 偏袒的； 钟爱的	n.  [数学]偏微商；	
participate	[pɑ:ˈtɪsɪpeɪt]	vi.  参加某事； 分享某事；	vt.  得到或接受某部分东西；	
particle	[ˈpɑ:tɪkl]	n.  微粒，颗粒； [数，物]粒子，质点； 极小量； 小品词	
particularly	[pəˈtɪkjələli]	adv.  特别； 尤其； 异乎寻常地；	
partner	[ˈpɑ:tnə(r)]	n.  伙伴； 同伙； 同伴； 配偶	vt.  使合作； 与…合伙；	vi.  合伙； 合股； 成为搭档；	
passion	[ˈpæʃn]	n.  激情，热情； 热心，爱好； 热恋； 酷爱	vt.&vi.  [诗歌用语]表露强烈感情，显示巨大热情；	
passive	[ˈpæsɪv]	adj.  被动的； 消极的； 不抵抗的； 冷漠的	n.  动词被动形式，被动语态；	
passport	[ˈpɑ:spɔ:t]	n.  护照，通行证； 手段；	
paste	[peɪst]	n.  面团； 糨糊； 肉（或鱼等）酱（作涂抹料或烹饪用）； （制作人造宝石的）铅质玻璃	vt.  粘贴，张贴； 以…覆盖于；	
pat	[pæt]	vt.& vi.  轻拍，爱抚； 拍成，拍至；	n.  轻拍； 轻拍某物发出的声音； 小团，小块；	adj.  恰好的，适当的； 熟练的； 过于巧合的，人为的； 快活的，活泼的	vt.  表扬，称赞（某人/自己）；	
patch	[pætʃ]	n.  补丁，补片； 眼罩； 斑点； 小块	vt.  修补，拼凑； 暂时遮掩一下； 修理，平息（吵架等）； 用美人斑装饰（脸）	vi.  打补丁；	
patience	[ˈpeɪʃns]	n.  耐心，耐性； 忍耐； 单人纸牌游戏；	
patient	[ˈpeɪʃnt]	adj.  有耐性的； 能容忍的；	n.  患者； 病人； 病号；	
pattern	[ˈpætn]	n.  模式； 花样，样品； 图案； 榜样，典范	vt.  模仿； 以图案装饰；	vi.  形成图案；	
paw	[pɔ:]	n.  爪子； 手； 笔迹；	vt.  用爪抓； 用蹄触； 盘弄； 艰苦地行走	vi.  用爪子抓； 翻找；	
payment	[ˈpeɪmənt]	n.  付款，支付； 报酬，报答； 偿还； 惩罚，报应	
pea	[pi:]	n.  豌豆，豌豆类； 豌豆状物； 〈美俚〉棒球；	
peak	[pi:k]	n.  山峰； 最高点； 尖端； 帽舌	vi.  达到高峰，达到最大值； 消瘦； 变憔悴；	adj.  最高的； 最大值的；	
peculiar	[pɪˈkju:liə(r)]	adj.  奇怪的，古怪的； 异常的； 特有的，特殊的；	n.  专有特权，专有财产； [多用于英国]特殊教堂；	
peer	[pɪə(r)]	vi.  凝视； 盯着看； 隐退，若隐若现； 同等，比得上	n.  同辈，同等的人； 贵族； 同伴，伙伴；	adj.  贵族的； （年龄、地位等）同等的； 相匹敌的；	
penalty	[ˈpenəlti]	n.  惩罚； 刑罚； 害处； 足球点球	
penetrate	[ˈpenɪtreɪt]	vt.  穿透，刺入； 渗入； 秘密潜入； 洞悉，明了	vi.  穿透，穿过； 进入，渗入； 洞悉；	
pension	[ˈpenʃn]	n.  退休金，养老金； 膳宿费； 生活津贴； 寄宿学校	vt.  发给…养老金[退休金]； 准予退休，强迫退休（并发给退休金）；	
pepper	[ˈpepə(r)]	n.  胡椒； 辣椒； 胡椒粉；	vt.  在…上撒胡椒粉； 使布满； 连续击打；	
per	[pə(r)]	prep.  由； （表示根据）依照； （表示比率）（尤指数量，价格，时间）每；	adv.  每次； 每个； 照常； 按惯例	adj.  高的，过的，全的；	
perceive	[pəˈsi:v]	v.  意识到； 察觉，发觉； 理解；	
percentage	[pəˈsentɪdʒ]	n.  百分比，百分率； 比例，部分； [数]百分法； [商]手续费	
perception	[pəˈsepʃn]	n.  知觉； 觉察（力）； 观念； （农作物的）收获	
perform	[pəˈfɔ:m]	vt.& vi.  执行； 履行； 表演； 扮演	vt.  工作； 做； 进行； 完成	vi.  运行，表现； （驯兽）玩把戏；	
performance	[pəˈfɔ:məns]	n.  表演； 演技； 表现； 执行 成绩；	
permanent	[ˈpɜ:mənənt]	adj.  永久（性）的，永恒的，不变的，耐久的，持久的，经久的； 稳定的； 常务的，常设的；	n.  电烫发，烫发；	
permission	[pəˈmɪʃn]	n.  允许； 批准，正式认可，认可；	
persist	[pəˈsɪst]	v.  坚持； 固执； 存留； 继续存在	
personality	[ˌpɜ:səˈnæləti]	n.  生而为人； 人格，人品，个性； 人物； 名人	
personnel	None	None	
perspective	[pəˈspektɪv]	n.  透镜，望远镜； 观点，看法； 远景，景色； 洞察力	adj.  （按照）透视画法的； 透视的；	
pessimistic	[ˌpesɪˈmɪstɪk]	adj.  悲观的，厌世的； 悲观主义的；	
petrol	[ˈpetrəl]	n.  汽油；	
petroleum	[pəˈtrəʊliəm]	n.  石油；	
phase	[feɪz]	n.  阶段； 时期； 月相； （月亮的）盈亏	v.  分阶段实行； 逐步做； 使定相；	
phenomenon	[fəˈnɒmɪnən]	n.  现象，事件； 奇迹； 非凡的人；	
philosopher	[fəˈlɒsəfə(r)]	n.  哲学家，哲人； 思想家，学者； 豁达的人； 爱卖弄大道理者	
philosophy	[fəˈlɒsəfi]	n.  哲学； 哲学体系，哲学思想； 生活信条； 哲理	
physical	[ˈfɪzɪkl]	adj.  自然（界）的； 身体的； 物质的； 自然规律的	n.  身体检查，体格检查；	
physician	[fɪˈzɪʃn]	n.  医生，内科医生； 医学博士； （精神创伤的）医治者，抚慰者；	
physicist	[ˈfɪzɪsɪst]	n.  物理学家； 唯物论者； 自然科学家； 宇宙机械论者	
pierce	[pɪəs]	vt.  刺穿，戳穿； 刺破； 洞察； 深深打动	vi.  进入； 透入；	
pigeon	[ˈpɪdʒɪn]	n.  鸽子； 易受骗的人； 责任；	
pill	[pɪl]	n.  药丸； 弹丸； 口服避孕药； 讨厌鬼	vt.  使服用药丸； 把…制成药丸； 投票反对； 抢劫	vi.  服用药丸； 制成药丸； 起球；	
pillar	[ˈpɪlə(r)]	n.  柱，台柱，顶梁柱； 墩，柱脚； （组织、制度、信仰等的）核心；	
pillow	[ˈpɪləʊ]	n.  枕头； 垫子； 花边垫子；	vt.  搁于枕上； 当作枕头用；	vi.  以…为枕；	
pilot	[ˈpaɪlət]	n.  飞行员； 引航员； 向导； [机械学]导向器（或轴）	vt.  驾驶； 试验； 试点； 为（船舶）引航（或操舵）	adj.  试验性的； 导向的； 驾驶员的； 辅助的	
pinch	[pɪntʃ]	vt.  捏，掐； 挤痛，夹痛； 使（植物）枯萎，凋谢； 使紧缺，节制	vi.  挤痛，压痛； 吝惜，节约；	n.  匮乏； 少量，一撮； 困苦；	
pine	[paɪn]	n.  松树； 松木；	vi.  憔悴； 痛苦； 渴望；	vt.  为…悲哀； 哀悼； 消瘦； 渴望，渴慕	
pint	[paɪnt]	n.  品脱； 一品脱的量器或容器； 一品脱容器的东西；	
pit	[pɪt]	n.  井； 煤矿； 麻子； （赛车道旁的）修理加油站	vt.  使竞争； 使有凹陷； 使留疤痕，使有斑点； 使表面有坑	vi.  凹陷； 起凹点；	
pitch	[pɪtʃ]	n.  场地； 最高点； 音高； 说教	vt.  用沥青涂； 扔，投； 树起，搭起； 定位于	vi.  抛，扔； [棒球]当投手； 搭帐篷； 向前跌或冲	
planet	[ˈplænɪt]	n.  [天]行星； [占星]（左右人命运的）星相；	
plantation	[plɑ:nˈteɪʃn]	n.  种植园，大农场； 栽植； 殖民，殖民地；	
plastic	[ˈplæstɪk]	n.  塑料制品； 〈口〉（使用）信用卡； 整形； 可塑体	adj.  可塑的，塑性的，受范的，柔软的； 造型的，塑造的，给与形态的； 塑料[塑胶]的，塑料[塑胶]制的，合成树脂做的； 有形成力的，有创造力的	
platform	[ˈplætfɔ:m]	n.  台； 站台； 平台； 纲领	v.  把…放在台上； 为…设（平）台； （在台上）演讲；	
pledge	[pledʒ]	n.  保证，誓言； [法]抵押权； 公约； （表示友谊的）干杯	vt.& vi.  使发誓，保证； 典当，抵押；	vt.  许诺； 用…担保； 以誓言约束； 向…祝酒	vi.  作出庄重有约束力的誓言； 祝愿，祝酒；	
plentiful	[ˈplentɪfl]	adj.  丰富的； 富产的； 丰饶的； 充沛	
plot	[plɒt]	n.  地基，基址图； （戏剧、小说等的）情节； 一块地； 测算表 场景；	vt.  以图表画出，制图； 密谋； 把…分成小块； 为（文学作品）设计情节	vi.  设计作品情节； 标示于图表上； 密谋，暗中策划；	
plug	[plʌg]	n.  塞子； 插头； 消防栓； （内燃机的）火花塞	vt.& vi.  插上插头；	vt.  以（塞子）塞住； 插入； 〈俚〉枪击，殴打；	vi.  填塞，堵； 〈俚〉勤苦工作，用功；	
plunge	[plʌndʒ]	vt.  用力插入； 使陷入；	vi.  跳入； 全心投入； 突降，俯冲；	n.  投入，陷入； 游泳，跳水； 暴跌；	
plural	[ˈplʊərəl]	adj.  复数的； 复数形式的； 多样的； 多元的	n.  复数； 复数形式； 复数词；	
plus	[plʌs]	prep.  （表示运算）加； （表示包容）外加； [口语]和； （表示数目）在零（度）以上	n.  加号； [数学]正量； 好处； 附加物	adj.  加的； 正的； 附加的； 比所示数量多的	
poem	[ˈpəʊɪm]	n.  诗； 韵文； 诗一样的作品； 富有诗意的东西	
poet	[ˈpəʊɪt]	n.  诗人； 空想家； 古典芭蕾舞大师；	
recommend	[ˌrekəˈmend]	vt.  推荐； 劝告； 使显得吸引人； 托付	vi.  推荐； 建议；	
recommendation	[ˌrekəmenˈdeɪʃn]	n.  推荐； 推荐信； 建议； 可取之处	
recorder	[rɪˈkɔ:də(r)]	n.  录音机； 直笛； 记录员； 刑事法院法官	
recover	None	None	
recovery	[rɪˈkʌvəri]	n.  恢复，复原； 重获； 痊愈； 矫正	
recreation	[ˌrekriˈeɪʃn]	n.  消遣（方式）； 娱乐（方式）； 重建，重现；	
recruit	[rɪˈkru:t]	n.  新兵； （机构中的）新成员； 新学生；	vt.  招聘，征募； 吸收某人为新成员； 动员…（提供帮助）； 雇用	vi.  征募新兵； 得到补充，得到补偿； 恢复健康；	
reduction	[rɪˈdʌkʃn]	n.  减少； 降低； [数学]约简； [摄影术]减薄	
reference	[ˈrefrəns]	n.  参考； 参考书； 提及，涉及； 证明人，介绍人	v.  引用； 参照；	
refine	[rɪˈfaɪn]	vt.  提炼； 改善； 使高雅；	
reflect	[rɪˈflekt]	vt.& vi.  反射（光、热、声或影像）； 考虑；	vt.  反射，反照； 表达； 显示； 折转	vi.  映出； 反射； 深思熟虑； 慎重表达	
reflection	[rɪˈflekʃn]	n.  反映； （关于某课题的）思考； （声、光、热等的）反射； 映像	
reflexion	[rɪ'flekʃən]	n.  反射，反射光； 反射作用（等于reflection）；	
reform	[rɪˈfɔ:m]	n.  改革，改良，改造； 改正；	vt.& vi.  改善；	vt.  改革； 重组；	vi.  重组；	adj.  改革的；	
refresh	[rɪˈfreʃ]	vt.  使恢复，使振作； 使焕然一新，翻新； 给（电池）充电；	vi.  恢复精神； 补充给养；	
refrigerator	[rɪˈfrɪdʒəreɪtə(r)]	n.  冰箱； 冷藏库； 制冰机，冷冻机；	
refugee	[ˌrefjuˈdʒi:]	n.  避难者，难民；	
refusal	[rɪˈfju:zl]	n.  拒绝； 优先取舍权；	
regarding	[rɪˈgɑ:dɪŋ]	prep.  关于； 就…而论； 至于；	v.  regard的现在分词；	
regardless	[rɪˈgɑ:dləs]	adv.  不顾后果地； 不管怎样，无论如何； 不惜费用地；	adj.  不重视的，不尊敬的； 不顾虑的，不关心的； 不受注意的，毫无价值的；	
region	[ˈri:dʒən]	n.  地区，地域，地带； 行政区，管辖区； （大气，海水等的）层，界，境； （学问等的）范围，领域	
register	[ˈredʒɪstə(r)]	n.  登记，注册； 记录； 登记簿； 自动记录器	vt.  登记，注册； （仪表等）指示； 表示，表达； （感情）流露	vi.  登记，注册； 留下印象； 完全符合； [印刷]对齐	
regulate	[ˈregjuleɪt]	vt.  调节，调整； 校准； 控制，管理；	
regulation	[ˌregjuˈleɪʃn]	n.  管理； 控制； 规章； 规则	adj.  规定的，必须穿戴的，必须使用的；	
reinforce	[ˌri:ɪnˈfɔ:s]	vt.  加固； 强化，增强； 增援；	vi.  求援； 得到增援； 给予更多的支持；	
reject	[rɪˈdʒekt]	vt.  拒绝； 抛弃，扔掉； 排斥； 吐出或呕吐	n.  被拒绝或被抛弃的人或事物；	
relate	None	None	
relationship	[rɪˈleɪʃnʃɪp]	n.  关系； 联系； 浪漫关系； 血缘关系	
relative	[ˈrelətɪv]	adj.  相关的； 相对的； 相互有关的； 比较而言的	n.  亲属，亲戚； 相关物； 亲缘植物（或动物）； [语法学]关系词	
relativity	[ˌreləˈtɪvəti]	n.  相对论； 相关性； 相对性；	
relax	[rɪˈlæks]	vt.& vi.  （使）轻松； （使）松弛； 放宽； （使）放松	vt.  缓和，减轻； （使大便等）通畅；	vi.  变得轻松； 变得随和； 变得和蔼； 通便	
release	[rɪˈli:s]	vt.  释放； 放开； 发布； 发行	n.  释放，排放，解除； 释放令； 公映的新影片，发布的新闻[消息]；	
relevant	[ˈreləvənt]	adj.  有关的，中肯的； 相关联的； 确切的； 有重大意义[作用]的，实质性的	
reliable	[rɪˈlaɪəbl]	adj.  可靠的； 可信赖的； 真实可信的；	n.  可靠的人；	
relief	[rɪˈli:f]	n.  宽慰，安心； 免除，减轻； 救援物资； 代班人	
relieve	[rɪˈli:v]	vt.  解除； 缓解； 换班； （去厕所的一种委婉说法）方便	
religion	[rɪˈlɪdʒən]	n.  宗教； 支配自己生活的大事； 教派； 心爱的事物	
religious	[rɪˈlɪdʒəs]	adj.  虔诚的； 笃信宗教的； 宗教的； 谨慎的	n.  修士，修女，出家人；	
reluctant	[rɪˈlʌktənt]	adj.  不情愿的，勉强的； 顽抗的； 难处理的； 厌恶的	
rely	[rɪˈlaɪ]	vi.  依靠，倚赖，仗恃； 信任，信赖；	
remain	[rɪˈmeɪn]	vi.  留下； 保持； 留待； 依然	n. .  遗迹；剩余物，残骸；	
remark	[rɪˈmɑ:k]	n.  注意，观察； 话语； 评论，谈论；	vt.& vi.  评论； 觉察；	
remarkable	[rɪˈmɑ:kəbl]	adj.  异常的，引人注目的，； 卓越的； 显著的； 非凡的，非常（好）的	
remedy	[ˈremədi]	n.  治疗法； 补救办法； 纠正办法； （硬币的）公差	vt.  改正，纠正，改进； 补救； 治疗；	
remind	[rɪˈmaɪnd]	vt.  使想起，使记起； 提醒；	
remote	[rɪˈməʊt]	adj.  （时间上）遥远的； 远离的； 远程的； 微小的	n.  远程操作； 遥控器；	vt.  使…向远方延伸，把…延展到远处；	
removal	[rɪˈmu:vl]	n.  免职； 除去； 移走； 搬迁	
render	[ˈrendə(r)]	v.  致使，造成； 给予； 递交； 表达	
renew	[rɪˈnju:]	vt.  重新开始； 使更新； 使恢复； 补充	vi.  重申，重复强调； 重新开始；	
rent	[rent]	n.  租金； 地租； （意见等的）分裂，分歧； （衣服等的）裂缝	vt.& vi.  出租； 付地租； “rend”的过去式和过去分词； 租借	adj.  撕碎的； 分裂的；	
repeatedly	[rɪ'pi:tɪdlɪ]	adv.  反复地，重复地； 再三地； 屡次地； 不停地	
repetition	None	None	
replace	[rɪˈpleɪs]	vt.  替换； 代替； 把…放回原位； （用…）替换	
replacement	[rɪˈpleɪsmənt]	n.  代替； 归还，，复位； 替代者； 补充兵员	
reporter	[rɪˈpɔ:tə(r)]	n.  记者；	
represent	[ˌreprɪˈzent]	vt.  表现，象征； 代表，代理； 扮演； 作为示范	vi.  代表； 提出异议；	
representative	[ˌreprɪˈzentətɪv]	n.  代表； 继任者； 议员； 类似物	adj.  典型的； 有代表性的； 代议制的； 相当[类似]（另一种属）的	
reproduce	[ˌri:prəˈdju:s]	vt.& vi.  复制，重现，再版； 生殖，繁殖；	vt.  使再次发生； 再现；	
republican	[rɪˈpʌblɪkən]	adj.  共和国的； 共和政体的； 共和主义的； 共和党的	n.  拥护共和政体者，共和主义者； 共和党人；	
reputation	[ˌrepjuˈteɪʃn]	n.  名气，名声； 好名声； 信誉，声望； 荣誉，名望	
require	[rɪˈkwaɪə(r)]	vt.  要求； 需要； 想要； 命令	vi.  要求，规定；	
requirement	[rɪˈkwaɪəmənt]	n.  要求； 必要条件； 必需品，需要量； 资格	
rescue	[ˈreskju:]	vt.  营救，救援，使免遭损失； [法律] 非法劫回；	n.  营救，救援； 营救[救援]行动；	
resemble	[rɪˈzembl]	vt.  与…相像，类似于；	
reservation	[ˌrezəˈveɪʃn]	n.  保留； 预订，预约； 保留地，专用地；	
reserve	None	None	
reservior	None	None	
residence	[ˈrezɪdəns]	n.  住处，住宅； 居住时间，居住； 公馆； 驻地	
resident	[ˈrezɪdənt]	adj.  定居的，常驻的； [计]常驻的，常存于内存中的； [动]不迁徙的（鸟兽等）； 固有的，内在的	n.  居民； （旅馆的）住宿者； 住院医师；	
resign	[rɪˈzaɪn]	v.  辞职； 放弃； 屈从； 勉强接受	
resist	[rɪˈzɪst]	v.  抵抗，抗拒； 忍耐； 反对，抵制；	n.  防染剂； 防腐剂；	
resistance	[rɪˈzɪstəns]	n.  抵抗； 阻力； 抗力； 电阻	
resistant	[rɪˈzɪstənt]	adj.  有抵抗力的，抵抗的； 顽固的；	n.  抵抗者； 有抵抗力的东西； 防染剂，防腐剂；	
resolution	[ˌrezəˈlu:ʃn]	n.  决心； 解决； 坚决； 分辨率	
resolve	[rɪˈzɒlv]	vt.& vi.  决定； 决心；	vt.  使消释； 使分解，使解体； （指委员会或集会）表决； 消退（炎症等）	vi.  下决定； 分解； 解决；	n.  决意，决定，坚决； （会议等的）决议；	
resort	[rɪˈzɔ:t]	n.  求助，凭借，诉诸； 度假胜地； 应急措施；	v.  诉诸； 采取；	
resource	[rɪˈsɔ:s]	n.  资源； 物力，财力； 办法； 智谋	
respect	None	None	
respective	[rɪˈspektɪv]	adj.  各自的，分别的；	
respectively	[rɪˈspektɪvli]	adv.  各自地； 各个地； 分别地；	
respond	[rɪˈspɒnd]	vt.& vi.  回答，响应；	vi.  作出反应，响应； 回报或回复；	n.  [建]（柱，拱基等的）对称，壁联；	
slim	[slɪm]	adj.  苗条的，纤细的； 微小的； 细长的； 无价值的	vi.  使苗条； 减肥；	
slip	None	None	
slippery	[ˈslɪpəri]	adj.  狡猾的； 滑溜的； 不可靠的；	
slope	[sləʊp]	n.  斜坡； 斜面； 倾斜； 斜率	vi.  倾斜； 有斜度； 悄悄地走； 潜行	vt.  使倾斜；	
smash	[smæʃ]	v.  打碎； 撞击； 猛击； 扣球	n.  打碎； 撞车； 扣球； 十分走红的歌曲	
snap	[snæp]	vt.& vi.  猛地咬住； 呵斥； 折断；	vt.  拍照； 用子母扣扣； [棒球]快速传（球）； 拍…的快照	n.  （树枝等的）突然折断； 严厉的话； 突然的撕咬； 尤指关上或断裂的声音)啪嗒声	vi.  啪啪作响； （目光）闪耀； （牙齿等）咯咯作响； （精神）突然崩溃	adj.  容易的； 喀嗒一声扣下的； 仓促的；	adv.  噼啪作响地； 啪嗒一声； 猛然；	
soak	[səʊk]	vt.  浸泡，浸透； 吸入； 沉浸在（工作或学习中）； 湿透	vi.  浸泡； 渗透或浸透，渗出； 讲话者暂停了一下； [俚语] 酗酒	n.  湿透； 酒鬼； 浸湿性； [俚语]醉汉	
soar	[sɔ:(r)]	vi.  高飞； 飞腾； 猛增，剧增； 高耸，屹立	n.  高飞； 高涨； 高飞范围； 上升高度	vt.  高飞越过； 飞升到；	
so-called	[səʊ	adj.  所谓的，号称的；	
social	[ˈsəʊʃl]	adj.  社会的，社会上的； 交际的，社交的； 群居的； 合群的	n.  联谊会，联欢会； 社交聚会；	
socialism	[ˈsəʊʃəlɪzəm]	n.  社会主义；	
socialist	[ˈsəʊʃəlɪst]	n.  社会主义者；	adj.  社会主义的； 社会党的；	
soda	[ˈsəʊdə]	n.  苏打； 碳酸钠； 苏打水，汽水； 苏打点心	
software	[ˈsɒftweə(r)]	n.  软件； 软体； 软设备；	
solar	[ˈsəʊlə(r)]	adj.  太阳的，日光的； 利用太阳能的； 根据太阳决定或测定的；	n.  日光浴室；	
sole	[səʊl]	adj.  单独的； 唯一的； 专有的，独占的；	n.  鞋底； 有…底的 -soled； 脚底； 鳎（可食用比目鱼）	vt.  给（鞋）换底；	
solemn	[ˈsɒləm]	adj.  庄严的，严肃的； 庄重的； 隆重的，神圣的； 犹豫的，阴沉的	
solution	[səˈlu:ʃn]	n.  解决； 溶解； 溶液； 答案	
solve	[sɒlv]	vt.  解决； 解答； 解释； 清偿（债务）	
somehow	[ˈsʌmhaʊ]	adv.  以某种方式，用某种方法； 不知怎么地，不知道怎样，不晓得什么缘故； 设法，想办法，想个方法； 莫明其妙地	
somewhat	[ˈsʌmwɒt]	adv.  稍微； 有点； 达到某种程度；	n.  少量； 某些数量； 某种程度；	
sophisticated	[səˈfɪstɪkeɪtɪd]	adj.  复杂的； 精致的； 富有经验的； 深奥微妙的	v.  使变得世故； 使迷惑； 篡改(sophisticate的过去分词形式)；	
sore	[sɔ:(r)]	adj.  疼痛的； 使人伤心的； 恼火的，发怒的；	n.  （肌肤的）痛处，伤处；	adv.  〈古，诗〉同sorely；	
sorrow	[ˈsɒrəʊ]	n.  悲痛； 悔恨，惋惜； 伤心事；	vt.& vi.  悲痛； 遗憾；	
sour	[ˈsaʊə(r)]	adj.  有酸味的； 敌对的； 坏脾气的； 别扭的	vi.  变酸，变馊； 发酵； 厌烦； 败坏	vt.  变坏，恶化； 使变酸； 使失望； 使不毛	n.  酸味； 苦事；	
source	[sɔ:s]	n.  根源，本源； 源头，水源； 原因； 提供消息的人	vt.  （从…）获得； 发起； 向…提供消息； 寻求（尤指供货）的来源	vi.  原料来源； 起源； 寻求来源； 寻求生产商（或提供商）	
sow	[səʊ]	vt.& vi.  播（种），播种于；	vt.  灌输； 激起； 散布； 煽动	n.  母猪；	
spacecraft	[ˈspeɪskrɑ:ft]	n.  [航天]宇宙飞船，航天器；	
spade	[speɪd]	n.  铁锹，铲子； （纸牌中的）黑桃；	
span	[spæn]	n.  共轭（马、骡）； 跨度，墩距； 一段时间； [航] 跨绳	vt.  缚住或扎牢； 跨越时间或空间； 以掌测量； 以手围绕测量类似测量	
spark	None	None	
specialist	[ˈspeʃəlɪst]	n.  专家； 行家； 专科医生；	
specialize	[ˈspeʃəlaɪz]	vi.  专门从事； 专攻； 详细说明； 特化	vt.  使专门化； 使适应特殊情况； 详细说明； 列举	
species	[ˈspi:ʃi:z]	n.  物种； 种类； 类型； [逻辑] 个体	
specific	[spəˈsɪfɪk]	adj.  明确的； 特种的； 具体的； [免疫学]特效的	n.  特效药； 特性； 细节； 显著的性质，特性	
specifically	[spəˈsɪfɪkli]	adv.  特有地，明确地； 按种别地； 按特性地；	
specify	[ˈspesɪfaɪ]	vt.  指定； 详述； 提出…的条件； 使具有特性	vi.  明确提出，详细说明；	
specimen	[ˈspesɪmən]	n.  样品； 范例； （化验的）抽样； 某种类型的人	
spectacular	[spekˈtækjələ(r)]	adj.  场面富丽的，壮观的； 引人注意的； 惊动一时的； 惊人的	n.  壮观的场面，精彩的表演； 〈美〉一小时半以上的大场面电视节目； 特大霓虹灯广告；	
speculate	[ˈspekjuleɪt]	vt.  思索，猜测，推测；	vi.  投机； 推测； 思索；	
spelling	[ˈspelɪŋ]	n.  拼写； 拼法；	v.  拼写( spell的现在分词)； 意味着；	
sphere	[sfɪə(r)]	n.  球（体）； （兴趣或活动的）范围； 势力范围； 天体，如行星或恒星	v.  将…封入球体中； 包围；	
spider	[ˈspaɪdə(r)]	n.  蜘蛛； 星形轮，十字叉； 带柄三脚平底锅； 三脚架	
spill	[spɪl]	vt.& vi.  溢出； 泼出； 涌出； 蜂拥而出	vt.  使跌落； 泄露机密；	n.  洒出（量）； 泼出（量）； 溢出（量）； 小塞子	
spin	[spɪn]	vi.  纺纱； 吐（丝），作（茧），结网； 快速旋转； 眩晕	vt.  纺（线）； 吐丝，将…抽成丝； 讲述，尤指通过想象地； 使延长，使延伸	n.  旋转的行为； 快速的旋运动； 眩晕； 疾驰	
spiritual	[ˈspɪrɪtʃuəl]	adj.  精神的； 心灵的； 高尚的，崇高的； 宗教的	n.  圣歌（尤指美国南部黑人的）； 教会事物；	
spit	[spɪt]	vt.  吐，吐出；	n.  唾沫； 口水； 烤肉叉；	vi.  吐痰，吐口水； 发出劈啪声；	
spite	[spaɪt]	n.  恶意； 怨恨； 恶事；	vt.  向…表示恶意； 欺负； 刁难； 泄愤	
splendid	[ˈsplendɪd]	adj.  壮观的，豪华的； 极好的或令人满意的； 闪亮的； 为众人所推崇的	
split	[splɪt]	vt.  分裂； 分开； （迅速）离开； 分担	n.  划分； 分歧； 裂缝； 劈叉	vi.  走开； 揭发； 被撞碎； [证券]（股票）增加发行	adj.  裂开的，劈开的，分离的，分裂的；	
spoil	[spɔɪl]	vi.  变质； 掠夺； 腐败；	vt.  损坏，糟蹋； 把（酒，肉等）放坏； 溺爱坏，宠坏（孩子等）； 抢劫，掠夺	n.  抢劫，掠夺； 废品，次品； 成功所带来的好处； （开掘等时挖出的）弃土	
spokesman	[ˈspəʊksmən]	n.  发言人，代言人；	
sponsor	[ˈspɒnsə(r)]	n.  发起者，主办者； 担保者； 倡议者，提案人； 后援组织	vt.  赞助；	
spot	[spɒt]	n.  地点，场所； 斑点，污点； [股票]现货； 职位，职务	v.  弄上污渍，弄上斑点； 污辱，玷污； 认出，发现； 散步	adj.  现场的； 现货的； 插播的；	abbr.  satellite positioning and tracking 卫星定位和跟踪；	
spray	[spreɪ]	vt.& vi.  喷； 喷射；	n.  喷雾； 喷雾器； 浪花； （用作装饰的）小树枝	
spur	[spɜ:(r)]	n.  马刺； 鞭策； 激励； （公路或铁路的）支线	v.  鼓动；  激励； 使更快发生； 策马前进	
squeeze	[skwi:z]	vt.& vi.  挤，榨，捏； 压迫，压榨；	vt.  榨取，汲取； 轻轻地捏； 向…勒索（或榨取）；	vi.  在强压下屈服； 施加压力； 挤过去；	n.  挤压，压榨； 抱紧，拥挤； 拥挤的人群； 压力	
stable	[ˈsteɪbl]	adj.  稳定的； 沉稳[持重]的； [物理学]稳定平衡的； 持久的	n.  厩，马厩，马棚，牛棚； 畜舍； 统称某人拥有（或训练的）赛马； 在同一地方工作或训练的)一批人	vt.  使关进畜舍（或马厩、牛棚等），使放入马厩般的室内；	vi.  被关在畜舍内，（人）生活在厩一般的地方；	
stack	[stæk]	n.  垛，干草堆； （一排）烟囱； 层积； 整个的藏书架排列 书架；	vt.& vi.  堆成堆，垛； 堆起来或覆盖住； 洗牌作弊； 秘密事先运作	
stadium	[ˈsteɪdiəm]	n.  运动场； 体育场； [医]（疾病的第…）期；	
staff	[stɑ:f]	n.  参谋； 全体职员； 管理人员； 权杖	adj.  行政工作的； 参谋的； 职员的； 作为正式工作人员的	v.  在…工作； 为…配备职员； 任职于；	
stain	[steɪn]	vi.  弄脏； 污染； 被玷污；	vt.  玷污，染污； 败坏（名声）； 给…染色；	n.  污点； 瑕疵； 着色剂； 色斑	
stake	[steɪk]	n.  桩； 刑柱； 股份； （在公司、计划等中的）重大利益	vt.  用桩支撑； 以…下注[打赌]； 用桩区分，界分；	
stale	[steɪl]	adj.  陈腐的； 不新鲜的； 走了味的；	v.  变陈旧； 变得不新鲜； （牛马、骆驼等）撒尿；	n.  （牛马、骆驼的）尿；	
standpoint	[ˈstændpɔɪnt]	n.  立场，观点；	
stare	[steə(r)]	vi.  盯着看； 显眼； 倒立，直竖起；	vt.  凝视； 盯着他的眼睛；	n.  凝视，瞪视；	
starve	[stɑ:v]	vi.  挨饿； [非正式用语] 饥饿； 受饿； [古语] 冻死	vt.  使挨饿； 饿死；	
statement	[ˈsteɪtmənt]	n.  声明； （思想、观点、文章主题等的）表现； （文字）陈述； 结算单	vi.  （英国）对儿童进行特殊教育评估认定；	vt.  申请（小孩）有特殊教育需要；	
static	[ˈstætɪk]	adj.  静止的； 不变的； 静电的； [物]静力的	n.  静电； [物]静电（干扰）； 静力学； 争吵	
statistic	[stəˈtɪstɪk]	n.  统计资料中的一项； （一项）统计数据； 统计量； （对总体具有代表性的）典型统计论	adj.  统计（上）的，统计学（上）的；	
statue	[ˈstætʃu:]	n.  雕像，塑像；	vt.  用雕像装饰；	
status	[ˈsteɪtəs]	n.  地位； 情形，状态； 身份；	
steady	[ˈstedi]	adj.  稳定的，不变的； 镇定的，沉着的； 坚定的；	vt.  使稳定，使坚定；	n.  关系固定的情侣；	
steamer	[ˈsti:mə(r)]	n.  汽船，轮船； 蒸锅； 蒸汽机； 用蒸汽工作的人	
steep	[sti:p]	adj.  陡峭的，险峻的； 过分的，夸张的； 极高的； 急剧升降的	vt.  浸泡； 使渗透或沉溺； 使浸透；	vi.  在液体中浸泡；	n.  泡的行为或过程； 被浸泡的状态； 浸泡液；	
steer	[stɪə(r)]	vt.& vi.  驾驶； 操纵，控制； 引导；	vt.  掌（舵）；	vi.  行进；	n.  阉公牛，肉用公牛； 〈美俚〉建议； 关于行路（或驾驶）的指示；	
stem	[stem]	n.  （花草的）茎； 词干； （高脚酒杯的）脚； 烟斗柄	vt.  遏制[阻止]（液体的流动等）； 阻止； 封堵； 遏止	
sticky	[ˈstɪki]	adj.  粘性的； 热湿的，闷热的； 极不愉快的； 不动的	
stiff	[stɪf]	adj.  严厉的； 僵硬的，坚硬的； 呆板的，拘谨的； 顽固的	adv.  极度地，非常；	n.  死尸； 笨蛋，傻瓜； 流动工人； 吝啬鬼穷光蛋	vt.  诈骗； 失信；	
stimulate	[ˈstɪmjuleɪt]	vt.  刺激； 激励，鼓舞； 使兴奋；	vi.  起兴奋作用； 起促进作用； 起刺激作用；	
sting	[stɪŋ]	vt.  叮，螫； 刺痛； 精神上刺痛； 刺激	vi.  感到剧痛； 刺，叮；	n.  螫伤处； （某些昆虫的）毒刺； （身体或心灵的）剧痛； （警察为抓捕罪犯而设的）圈套	
tremendous	[trəˈmendəs]	adj.  极大的，巨大的； 可怕的，惊人的； 极好的；	
trend	[trend]	n.  走向； 趋向； 时尚，时髦；	vi.  倾向； 趋势；	
trial	[ˈtraɪəl]	n.  试验； [法]审讯，审判； 磨难，困难； [体]选拔赛	adj.  试验的； [法]审讯的；	
triangle	[ˈtraɪæŋgl]	n.  三角形； 三人一组； 三角铁； 三角板	
trim	[trɪm]	vt.  修剪； 整理； 装饰；	adj.  整齐的，整洁的； 修长的； 苗条的；	n.  整齐； 修剪； 健康状态； 装束	vi.  削减；	
triumph	[ˈtraɪʌmf]	n.  胜利； 巨大的成就； （成功的）典范； （巨大成功或胜利的）心满意足	vi.  获胜； 克服； 打败； 战胜	
troop	[tru:p]	n.  军队； 一群； [军]骑兵连；	vi.  成群结队地走； 群集； 结队；	vt.  把（骑兵）编成骑兵连；	
tropical	[ˈtrɒpɪkl]	adj.  热带的； 炎热的； 热情的；	
troublesome	[ˈtrʌblsəm]	adj.  令人讨厌的； 令人烦恼的； 引起麻烦的； （孩子等）难管的	
truly	[ˈtru:li]	adv.  真正； 精确地，正确地； 忠实的，诚实地； 正当地	
trumpet	[ˈtrʌmpɪt]	n.  喇叭； 小号； [乐]音栓； 喇叭似的声音	vt.  大声说出或宣告；	vi.  吹喇叭，吹小号； 发出回声；	
trunk	[trʌŋk]	n.  树干； 象鼻； 躯干； 汽车车尾的行李箱 泳裤；	
tube	[tju:b]	n.  管，管状物； 电子管； 地铁； 电视机	vt.  把…装管； 把…弄成管状； 用管输送；	vi.  乘地铁； 不及格；	
tune	[tju:n]	n.  曲调，曲子； 和谐，调谐； 语调； 心情	vt.  调整； 使和谐，使一致； 调整（频率）； 为…调音	vi.  协调； [无线]调谐；	
tunnel	[ˈtʌnl]	n.  隧道； 地道； 烟道； （动物栖息的）穴	vi.  打通隧道； 挖掘隧道；	vt.  在…挖掘隧道； 在…打开通道；	
turbine	[ˈtɜ:baɪn]	n.  涡轮机； 汽轮机； 透平机；	
tutor	[ˈtju:tə(r)]	n.  家庭教师； 导师； （大专院校的）助教； 课本	vt.& vi.  当家庭教师； 任大学导师； 任课；	
twist	None	None	
typewriter	[ˈtaɪpraɪtə(r)]	n.  打字机；	
typical	[ˈtɪpɪkl]	adj.  典型的； 特有的或特别的； 代表性的；	
typist	[ˈtaɪpɪst]	n.  打字员；	
tyre	['taɪə(r)]	n.  轮胎；	
ugly	[ˈʌgli]	adj.  难看的； 丑陋的； 有敌意的； 不祥的	n.  丑陋的人（东西）；	
ultimate	[ˈʌltɪmət]	adj.  最后的； 极限的； 首要的； 最大的	n.  终极； 顶点； 基本原理； 基本事实	
umbrella	[ʌmˈbrelə]	n.  雨伞； 〈比喻〉保护物； [军]空中掩护幕； 总括	
uncover	[ʌnˈkʌvə(r)]	vt.  揭开…的盖子； 揭露，发现； 拿下（头上）戴的东西，脱（帽）； 将（狐）赶出	vi.  发现，揭示；	
undergo	[ˌʌndəˈgəʊ]	vt.  经历，经验； 遭受，承受；	
undergraduate	[ˌʌndəˈgrædʒuət]	n.  本科生； （未获学士学位的）大学生，大学肄业生；	
underground	[ˈʌndəgraʊnd]	adj.  地下的； 秘密的； 先锋派的； 隐蔽的	
underline	[ˌʌndəˈlaɪn]	vt.  在…下面画线； 加强，强调；	n.  下划线； 下期节目预告； 图下说明文字；	
underneath	[ˌʌndəˈni:θ]	adj.  较低的； 下面的；	adv.  在下面，在底下； 在下面，在下层；	prep.  在…之下； 在下面； 在…下面； 在…领导或控制下	n.  下部，底部；	
understanding	[ˌʌndəˈstændɪŋ]	vt.  理解，懂得； 熟知，通晓； 获知，理解； 谅解	vi.  理解，懂得； 表示同情或谅解； 据说；	n.  认识，了解； 谅解； 知识；	adj.  能谅解的； 宽容的； 通情达理的；	
undertake	[ˌʌndəˈteɪk]	vt.  承担，从事； 保证； 同意，答应； 承诺	
undo	[ʌnˈdu:]	vt.  松开，解开； 取消，废除； 毁灭； 扰乱	vi.  撤销；	
undoubtedly	[ʌn'daʊtɪdlɪ]	adv.  毋庸置疑地，的确地； 显然； 必定； 无疑	
uneasy	[ʌnˈi:zi]	adj.  心神不安的； 不稳定的； 不舒服的；	
unexpected	[ˌʌnɪkˈspektɪd]	adj.  想不到的，料不到的； 意外的； 忽然的； 突然的	
unfortunately	[ʌnˈfɔ:tʃənətli]	adv.  不幸地，遗憾地； 可惜； 不巧；	
union	[ˈju:niən]	n.  同盟，联盟； 协会，工会； 联合，团结；	adj.  工会的；	
unique	[juˈni:k]	adj.  唯一的，仅有的； 独一无二的，独特的； 不平常的，特别的； 超绝	
unite	[juˈnaɪt]	vt.  （使）联合，合并，统一； 并有，兼备； 混合，化合；	vi.  （为某事）联合，联手，团结；	
unity	[ˈju:nəti]	n.  统一体； （艺术等）完整； （文学、戏剧）（情节、时间和地点的）统一性； 团结一致	
universal	[ˌju:nɪˈvɜ:sl]	adj.  普遍的，一般的； 通用的，万能的； 全世界的； 宇宙的	n.  [逻辑学]全称命题； [哲学]一般概念； 一般性；	
universe	[ˈju:nɪvɜ:s]	n.  宇宙； 天地万物；  经验领域；	
unless	[ənˈles]	conj.  除非，如果不；	prep.  除了，…除外；	
unlike	[ˌʌnˈlaɪk]	prep.  （表示属性）与…不同； 不像；	adj.  不同的； 相异的； 不相似的；	
unload	[ˌʌnˈləʊd]	vt.  卸货； 去除负担； 倾吐； 处理，倾销	vi.  卸下货物或其它负担； 退子弹； [商]抛售（证券）；	
unusual	[ʌnˈju:ʒuəl]	adj.  不常见的，不普通的，难得的，罕有的； 异乎寻常的，例外的，奇异的； 独特的； 与众不同的	
upper	[ˈʌpə(r)]	adj.  地位较高的； 上面的； 内地的； 地表层的	n.  鞋帮，靴面； 兴奋剂； 令人兴奋的经历；	
upright	[ˈʌpraɪt]	adj.  直立的； 垂直的； 正直的； 诚实的	adv.  垂直[竖立]地；	n.  （支撑用的）直柱，立放构件；	
upset	[ʌpˈset]	vi.  打翻，弄翻； 打乱，打搅；	vt.  打乱，搅乱； 推翻，弄翻； 使心烦意乱； 使翻倒	n.  翻倒，颠覆； 心烦意乱； 混乱；	adj.  难过的； 失望的； 沮丧的； （肠胃）不舒服的	
up-to-date	['ʌptə'deɪt]	adj.  现代的，最新的； 最近的； 新式的；	
urban	[ˈɜ:bən]	adj.  都市的； 具有城市或城市生活特点的； 市内；	
urge	[ɜ:dʒ]	vt.  催促； 推进，驱策； 力劝，规劝； 极力主张	n.  刺激，冲动； 推动力；	vi.  催促； 强烈要求，竭力主张；	
urgent	[ˈɜ:dʒənt]	adj.  急迫的； 催促的； 强求的； 极力主张的	
usage	[ˈju:sɪdʒ]	n.  使用； 用法； 习惯； 惯例	
utility	[ju:ˈtɪləti]	n.  功用，效用； 有用的物体或器械； 公用事业（公司）； 水电费	adj.  有多种用途的； 各种工作都会做的； 能在数个位置作替补的； 为获得经济价值而饲养	
utilize	[ˈju:təlaɪz]	vt.  利用，使用；	
utmost	[ˈʌtməʊst]	adj.  极度的，最大的，最远的；	n.  极限，最大限度；	
utter	[ˈʌtə(r)]	vt.  发出声音； 说，讲； 出版（书籍）等； [法]流通使用	adj.  彻底的，完全的，绝对的；	
vacant	[ˈveɪkənt]	adj.  空闲的； 空缺的； 空虚的； 茫然的	
vacation	[vəˈkeɪʃn]	n.  假期，休假； [古] 空出，撤出，辞去；	vi.  度假；	
vacuum	[ˈvækjuəm]	n.  真空； 空白； 空虚； 清洁	v.  用真空吸尘器清扫；	
vague	[veɪg]	adj.  模糊的； （思想上）不清楚的； （表达或感知）含糊的； 暧昧的	n.  模糊不定状态；	
vain	[veɪn]	adj.  徒劳的； 自负的； 无结果的； 无用的	
valid	[ˈvælɪd]	adj.  有效的； 有法律效力的； 正当的； 健全的	
van	[væn]	n.  先锋； 厢式货车； 增值网； 先驱，前驱，领袖，领导人	vt.  用车搬运；	prep.  〈外〉同“from”；	
vanish	[ˈvænɪʃ]	vi.  消失； 突然不见； 消亡，消灭； [数]化为零	vt.  使消失，使不见；	n.  [语音学]消失音，弱化音；	
vapour	[ˈveɪpə(r)]	n.  潮气，水汽； 蒸汽（等于vapor）；	adj.  蒸发的，自夸的；	
variable	[ˈveəriəbl]	adj.  变化的，可变的； [数]变量的； [生]变异的；	n.  可变因素，变量； 易变的东西；	
variation	[ˌveəriˈeɪʃn]	n.  变化，变动； 变异，演变； 变奏曲； 变量	
variety	None	None	
various	[ˈveəriəs]	adj.  各种各样的； 多方面的； 许多的； 各个的，个别的	
vary	[ˈveəri]	vi.  变化； 不同，偏离； [生]变异；	vt.  使不同； 使多样化； [音乐]变奏；	
vast	[vɑ:st]	adj.  广阔的； 巨大的； 大量的； 巨额的	n.  浩瀚； 广大无边的空间；	
vehicle	[ˈvi:əkl]	n.  车辆； 交通工具； 手段； 工具	
venture	[ˈventʃə(r)]	n.  冒险事业； 冒险； 冒险行动； 商业冒险	vt.  冒…的危险； 拿…冒险； 用…进行投机； 以…做赌注	vi.  冒险前进，冒险行事； 猜测（常与at连用）；	
verify	[ˈverɪfaɪ]	vt.  核实； 证明； 判定；	
version	[ˈvɜ:ʃn]	n.  版本； 译文，译本； 说法； 倒转术	
vertical	[ˈvɜ:tɪkl]	adj.  垂直的，竖立的； [解]头顶的； 顶点的； [植]纵长的，直上的	n.  垂直线，垂直面； [建]竖杆； 垂直位置；	
vessel	[ˈvesl]	n.  容器； 船，飞船； 血管，管束； …的化身	
interact	[ˌɪntərˈækt]	v.  相互作用； 互相影响； 交流，沟通； 合作	
invariably	[ɪnˈveəriəbli]	adv.  总是； 不变的； “invariable”的派生； 无不	
irrigation	[ˌɪrɪ'ɡeɪʃn]	n.  灌溉； 水利； [医]冲洗； 冲注洗剂	
likelihood	[ˈlaɪklihʊd]	n.  可能，可能性； [数]似然，似真；	
literacy	[ˈlɪtərəsi]	n.  识字； 有文化； 能读能写； 精通文学	
locality	[ləʊˈkæləti]	n.  位置； 地区； 产地；	
lounge	[laʊndʒ]	n.  休息厅； 客厅； （机场等的）等候室；	vi.  闲逛； 懒洋洋地躺；	vt.  懒洋洋地打发（时间）； 虚度光阴；	
memorize	[ˈmeməraɪz]	vt.  记住，熟记； [计算机科学] 存储，记忆；	
monetary	[ˈmʌnɪtri]	adj.  货币的，金钱的； 钱的（尤指一国的金融）； 金融的； 财政的，财政（上）的	
monopoly	[məˈnɒpəli]	n.  垄断； 专卖； 垄断者； 专利品	
morality	[məˈræləti]	n.  道德； 道德准则； 品德高尚的行为； 道德观	
muscular	[ˈmʌskjələ(r)]	adj.  肌肉的； 壮健的，肌肉发达的，强壮的；	
notwithstanding	[ˌnɒtwɪθˈstændɪŋ]	prep.  尽管； 虽然；	adv.  尽管如此，仍然； 还是；	conj.  虽然，尽管；	
nurture	[ˈnɜ:tʃə(r)]	vt.  养育； 培育； 滋养； 培植	n.  教养，培育； 营养物，食物； 环境因素；	
olive	[ˈɒlɪv]	n.  橄榄； 橄榄树； 橄榄色； 油橄榄	adj.  橄榄色的； 黄褐色的； 淡褐色的； 橄榄绿的	
optimum	[ˈɒptɪməm]	adj.  最适宜的；	n.  最佳效果； 最适宜条件； [生物学] 最适度；	
paperback	[ˈpeɪpəbæk]	n.  平装本，平装书；	
pedestrian	None	None	
permissible	[pəˈmɪsəbl]	adj.  可允许的； 许可的； 不碍事的； 得到准许的	
pest	[pest]	n.  讨厌的人或事； 害虫； 害鸟； 害兽 灾害；	
physiological	[ˌfɪzɪə'lɒdʒɪkl]	adj.  生理学的； 生理的；	
plague	[pleɪg]	n.  瘟疫； 灾害，折磨；	vt.  使染瘟疫； 使痛苦，造成麻烦；	
preach	[pri:tʃ]	vt.& vi.  布道，讲道； 宣扬； 说教； 讲（道）	n.  〈口〉讲道，说教；	
premature	[ˌprɛməˈtjʊə]	adj.  过早的； 提前的； 早产的； 草率的	
prescription	[prɪˈskrɪpʃn]	n.  [医]药方，处方； 处方药； 训令，指示； 法规	
prestige	[preˈsti:ʒ]	n.  威信，威望，声望； 声誉； （财势的）显赫； 信望	
prevalent	[ˈprevələnt]	adj.  流行的，盛行的； 普遍存在的，普遍发生的；	
productive	[prəˈdʌktɪv]	adj.  富有成效的； 多产的； 生产性的； 具有创造性的	
productivity	[ˌprɒdʌkˈtɪvəti]	n.  生产率，生产力； [经济学] 生产率； [生态学]生产率；	
profess	[prəˈfes]	vt.  声称； 宣称； 公开表明； 信奉	
profitable	[ˈprɒfɪtəbl]	adj.  有利可图的，有益的； 可赚钱的，合算的；	
profound	[prəˈfaʊnd]	adj.  深厚的； 意义深远的； 严重的； 知识渊博的	n.  〈诗〉深海，大洋； 深渊； （灵魂）深处；	
prospective	[prəˈspektɪv]	adj.  预期的； 未来的； 可能的； 有希望的	
pumpkin	[ˈpʌmpkɪn]	n.  南瓜； 南瓜的果肉，南瓜囊； 〈俚〉重要人物；	
purity	[ˈpjʊərəti]	n.  [化学]纯度； 纯洁，纯净； 清洁，清白，清廉； （语言）纯正	
pursuit	[pəˈsju:t]	n.  追赶； 工作；	
quest	[kwest]	n.  探索； 追求； 远征； 验尸陪审团	vt.  寻找； 探索；	vi.  进行探求； （猎犬等）跟踪搜寻；	
random	[ˈrændəm]	adj.  任意的； 随机的； 胡乱的；	n.  随意； 偶然的行动；	
rap	[ræp]	vt.& vi.  突然说出； （公开地）严厉批评； 突然大声说出； 连续敲叩	n.  （轻快的）敲击（声）； 说唱音乐； 说唱歌； 速度快的谈话	
recite	[rɪˈsaɪt]	vt.& vi.  背诵； 叙述； 列举；	vt.  详述，列举； 吟诵；	vi.  背诵； 叙述；	
reconcile	[ˈrekənsaɪl]	vt.  使和好，使和解； 调停，排解（争端等）； [宗]使（场所等）洁净； [船]使（木板）接缝平滑	
recycle	[ˌri:ˈsaɪkl]	vt.  回收利用； 使再循环；	vi.  重复利用；	
referee	[ˌrefəˈri:]	n.  裁判员； 证明人； 公断人； （专业性强的文章的）审阅人	vi.  担任裁判；	vt.  审阅，鉴定（专业性强的文章）； 为…当裁判； 仲裁判定；	
relay	[ˈri:leɪ]	n.  接替人员，替班； 传递； 接力赛； 继电器	vt.  转播，传达； 用驿马递送，使接替； 分程传递；	
repertoire	[ˈrepətwɑ:(r)]	n.  全部节目； 全部本领； （计算机的）指令表；	
residential	[ˌrezɪˈdenʃl]	adj.  住宅的，适于作住宅的； 与居住有关的； 适宜作住宅的；	
reunion	None	None	
revelation	[ˌrevəˈleɪʃn]	n.  [宗]天启，启示； 揭发，暴露； 被揭露出来的事物； 意外的发现	
revenge	[rɪˈvendʒ]	n.  报仇，报复；	vt.  为…报仇，报…之仇；	
revolve	[rɪˈvɒlv]	vt.& vi.  使旋转； 反复考虑； 使循环；	vi.  旋转； 循环出现； 反复考虑；	
scrutiny	[ˈskru:təni]	n.  细看，细阅； 仔细的观察； 监督；	
seemingly	[ˈsi:mɪŋli]	adv.  看来似乎； 表面上看来； 貌似；	
silicon	[ˈsɪlɪkən]	n.  硅； 硅元素；	
slogan	[ˈsləʊgən]	n.  标语，口号； 呐喊声； （商业广告上用的）短语；	
smuggle	[ˈsmʌgl]	vt.  偷运； 私运； 走私； 不按规章地偷带（人或物）	vi.  走私； 偷带；	
snack	[snæk]	n.  快餐，点心，零食； 加餐； 易办到的事；	vi.  吃点心（或快餐、小吃）；	
solitary	[ˈsɒlətri]	adj.  独自的，独立的； 单个的； 唯一的； 隐居的	n.  独居者，隐士； 单独禁闭；	
stability	None	None	
stationary	[ˈsteɪʃənri]	adj.  不动的，固定的； 静止的，不变的； 常备军的； 定居的	n.  不动的人； 驻军； 固定物；	
stereo	[ˈsteriəʊ]	adj.  立体声的； 有立体感的；	n.  立体声； 立体声系统； 铅板； 立体系统或立体像片	
stern	[stɜ:n]	adj.  严厉的，严峻的； 坚定的，不动摇的； 严肃的；	n.  船尾，艉； 末端； 斯坦恩，英语男子名；	
subjective	[səbˈdʒektɪv]	adj.  主观的； 个人的； 内省的；	
subordinate	None	None	
sue	[su:]	vt.& vi.  控告，控诉，和…打官司； 请求； 起诉； 提起（诉讼）要求判决	
telecommuications	None	None	
thereafter	[ˌðeərˈɑ:ftə(r)]	adv.  此后，在那之后； 〈罕〉据此；	
tile	[taɪl]	n.  瓦片，瓷砖； 空心砖； 麻将牌；	vt.  用瓦片、瓷砖等覆盖；	
timely	[ˈtaɪmli]	adj.  适时的； 及时的；	
token	[ˈtəʊkən]	n.  代币； 象征； 记号；	adj.  作为对某事的保证的； 象征性的； 作为标志的；	vt.  预兆：预示或象征，预兆；	
tolerant	[ˈtɒlərənt]	adj.  宽容的； 容忍的，忍受的； （植物、动物或机器）能在困难条件下生存（或操作）的； 能耐…的	
toll	[təʊl]	n.  通行费； 伤亡人数； 钟声； 长途电话费	v.  鸣钟； 敲钟；	
tract	[trækt]	n.  大片土地； （神经纤维的）束； 小册子； 一段时间，长时间	
transient	[ˈtrænziənt]	adj.  短暂的； 转瞬即逝的； 临时的；	n.  临时旅客； 瞬变现象； 候鸟；	
transition	[trænˈzɪʃn]	n.  过渡，转变，变迁； [语]转换； [乐]变调；	v.  转变，过渡；	
tuition	[tjuˈɪʃn]	n.  学费； 教学，讲授；	
unemployment	[ˌʌnɪmˈplɔɪmənt]	n.  失业； 失业率； 失业状况； 失业人数	
unify	[ˈju:nɪfaɪ]	vt.  使联合； 使相同； 使一致； 统一	
versus	[ˈvɜ:səs]	prep.  （表示两队或双方对阵）对； （比较两种不同想法、选择等）与…相对； 对抗；	
vocal	[ˈvəʊkl]	adj.  声音的，嗓音的； 由嗓音发出或产生的； 有声音的，能发出声音或语言的； 畅所欲言的	n.  元音； [音乐]声乐作品；	
vulnerable	[ˈvʌlnərəbl]	adj.  （地方）易受攻击的； 易受伤的； 易受批评的； [桥牌]已成局的	
wallet	[ˈwɒlɪt]	n.  钱包，皮夹子；	
